State/UTs_Code,District_Code,CD Block_Code,Town/Village_Code,Ward_Code,EB_Code,State/UTs_Name,District_Name,Level,Name,Total/Rural/Urban,Literates Population Person,Literates Population Male,Literates Population Female,Illiterate Persons,Illiterate Male,Illiterate Female
8,110,78,0,0,0,RAJASTHAN,Jaipur,CD BLOCK,Kotputli,Total,164232,102974,61258,111135,42340,68795
8,110,78,0,0,0,RAJASTHAN,Jaipur,CD BLOCK,Kotputli,Rural,164232,102974,61258,111135,42340,68795
8,110,78,0,0,0,RAJASTHAN,Jaipur,CD BLOCK,Kotputli,Urban,0,0,0,0,0,0
8,110,78,79000,0,0,RAJASTHAN,Jaipur,VILLAGE,Deota,Rural,1960,1177,783,1082,421,661
8,110,78,79001,0,0,RAJASTHAN,Jaipur,VILLAGE,Banar,Rural,1490,966,524,1064,377,687
8,110,78,79002,0,0,RAJASTHAN,Jaipur,VILLAGE,Chhardara,Rural,1199,732,467,571,178,393
8,110,78,79003,0,0,RAJASTHAN,Jaipur,VILLAGE,Ramgarh,Rural,846,474,372,448,185,263
8,110,78,79004,0,0,RAJASTHAN,Jaipur,VILLAGE,Panera,Rural,930,545,385,397,172,225
8,110,78,79005,0,0,RAJASTHAN,Jaipur,VILLAGE,Ramnagar,Rural,647,399,248,474,178,296
8,110,78,79006,0,0,RAJASTHAN,Jaipur,VILLAGE,Baneti,Rural,3384,2082,1302,2054,765,1289
8,110,78,79007,0,0,RAJASTHAN,Jaipur,VILLAGE,Dhawali,Rural,635,403,232,420,149,271
8,110,78,79008,0,0,RAJASTHAN,Jaipur,VILLAGE,Hasanpura,Rural,322,193,129,196,75,121
8,110,78,79009,0,0,RAJASTHAN,Jaipur,VILLAGE,Raikaranpura,Rural,1667,1044,623,841,324,517
8,110,78,79010,0,0,RAJASTHAN,Jaipur,VILLAGE,Bakhrana,Rural,1118,691,427,680,248,432
8,110,78,79011,0,0,RAJASTHAN,Jaipur,VILLAGE,Amarpura,Rural,812,528,284,623,231,392
8,110,78,79012,0,0,RAJASTHAN,Jaipur,VILLAGE,Nangal Checheeka,Rural,1001,641,360,862,316,546
8,110,78,79013,0,0,RAJASTHAN,Jaipur,VILLAGE,Jaisinghpura,Rural,961,621,340,720,263,457
8,110,78,79014,0,0,RAJASTHAN,Jaipur,VILLAGE,Gopalpura,Rural,2157,1414,743,1433,515,918
8,110,78,79015,0,0,RAJASTHAN,Jaipur,VILLAGE,Karwas,Rural,1062,633,429,603,229,374
8,110,78,79016,0,0,RAJASTHAN,Jaipur,VILLAGE,Banka,Rural,1040,626,414,651,236,415
8,110,78,79017,0,0,RAJASTHAN,Jaipur,VILLAGE,Kaloohera,Rural,631,412,219,427,137,290
8,110,78,79018,0,0,RAJASTHAN,Jaipur,VILLAGE,Gonera,Rural,2059,1284,775,1567,640,927
8,110,78,79019,0,0,RAJASTHAN,Jaipur,VILLAGE,Keshwanagujar,Rural,216,156,60,209,79,130
8,110,78,79020,0,0,RAJASTHAN,Jaipur,VILLAGE,Keshwana Rajput,Rural,1171,733,438,704,274,430
8,110,78,79021,0,0,RAJASTHAN,Jaipur,VILLAGE,Malpura,Rural,1127,749,378,871,305,566
8,110,78,79022,0,0,RAJASTHAN,Jaipur,VILLAGE,Mordha,Rural,1408,903,505,1031,352,679
8,110,78,79023,0,0,RAJASTHAN,Jaipur,VILLAGE,Paniyala,Rural,2464,1610,854,2012,771,1241
8,110,78,79024,0,0,RAJASTHAN,Jaipur,VILLAGE,Kherki Mukkar,Rural,1183,739,444,786,291,495
8,110,78,79025,0,0,RAJASTHAN,Jaipur,VILLAGE,Beenjahera,Rural,586,355,231,325,136,189
8,110,78,79026,0,0,RAJASTHAN,Jaipur,VILLAGE,Sangtera,Rural,1976,1187,789,842,284,558
8,110,78,79027,0,0,RAJASTHAN,Jaipur,VILLAGE,Shekhupur,Rural,542,327,215,296,86,210
8,110,78,79028,0,0,RAJASTHAN,Jaipur,VILLAGE,Molahera,Rural,1825,1182,643,1429,527,902
8,110,78,79029,0,0,RAJASTHAN,Jaipur,VILLAGE,Kherki Veerbhan,Rural,1277,801,476,722,268,454
8,110,78,79030,0,0,RAJASTHAN,Jaipur,VILLAGE,Kharkhari,Rural,705,438,267,473,178,295
8,110,78,79031,0,0,RAJASTHAN,Jaipur,VILLAGE,Ramsinghpura,Rural,1365,883,482,800,274,526
8,110,78,79032,0,0,RAJASTHAN,Jaipur,VILLAGE,Ajeetpura Khurd,Rural,474,277,197,302,137,165
8,110,78,79033,0,0,RAJASTHAN,Jaipur,VILLAGE,Poorannagar,Rural,647,433,214,630,247,383
8,110,78,79034,0,0,RAJASTHAN,Jaipur,VILLAGE,Nareda,Rural,4872,3008,1864,2607,943,1664
8,110,78,79035,0,0,RAJASTHAN,Jaipur,VILLAGE,Chimanpura,Rural,1209,779,430,909,326,583
8,110,78,79036,0,0,RAJASTHAN,Jaipur,VILLAGE,Narsinghpura,Rural,328,197,131,184,73,111
8,110,78,79037,0,0,RAJASTHAN,Jaipur,VILLAGE,Kayampura Was,Rural,1682,1005,677,953,332,621
8,110,78,79038,0,0,RAJASTHAN,Jaipur,VILLAGE,Bhopatpura,Rural,258,156,102,128,48,80
8,110,78,79039,0,0,RAJASTHAN,Jaipur,VILLAGE,Churi,Rural,1073,666,407,784,291,493
8,110,78,79040,0,0,RAJASTHAN,Jaipur,VILLAGE,Pawala Rajput,Rural,609,404,205,544,193,351
8,110,78,79041,0,0,RAJASTHAN,Jaipur,VILLAGE,Nawal Kushal Pura,Rural,256,154,102,175,66,109
8,110,78,79042,0,0,RAJASTHAN,Jaipur,VILLAGE,Padma Ki Dhani,Rural,431,265,166,298,118,180
8,110,78,79043,0,0,RAJASTHAN,Jaipur,VILLAGE,Kuhara,Rural,1071,737,334,873,321,552
8,110,78,79044,0,0,RAJASTHAN,Jaipur,VILLAGE,Kalyanpura Kalan,Rural,1243,808,435,928,316,612
8,110,78,79045,0,0,RAJASTHAN,Jaipur,VILLAGE,Kharab,Rural,2736,1761,975,1795,659,1136
8,110,78,79046,0,0,RAJASTHAN,Jaipur,VILLAGE,Pichani,Rural,657,417,240,483,183,300
8,110,78,79047,0,0,RAJASTHAN,Jaipur,VILLAGE,Shuklawas,Rural,1688,1104,584,1069,363,706
8,110,78,79048,0,0,RAJASTHAN,Jaipur,VILLAGE,Purushottampura,Rural,2000,1270,730,1469,584,885
8,110,78,79049,0,0,RAJASTHAN,Jaipur,VILLAGE,Beri,Rural,1730,1098,632,1380,548,832
8,110,78,79050,0,0,RAJASTHAN,Jaipur,VILLAGE,Sudarpura,Rural,1365,852,513,790,296,494
8,110,78,79051,0,0,RAJASTHAN,Jaipur,VILLAGE,Chacha Nehru Nagar,Rural,528,334,194,381,170,211
8,110,78,79052,0,0,RAJASTHAN,Jaipur,VILLAGE,Dhadha,Rural,864,546,318,585,222,363
8,110,78,79053,0,0,RAJASTHAN,Jaipur,VILLAGE,Talwa,Rural,552,376,176,586,252,334
8,110,78,79054,0,0,RAJASTHAN,Jaipur,VILLAGE,Gulabgarh,Rural,637,410,227,417,176,241
8,110,78,79055,0,0,RAJASTHAN,Jaipur,VILLAGE,Dantil,Rural,3398,2116,1282,2278,911,1367
8,110,78,79056,0,0,RAJASTHAN,Jaipur,VILLAGE,Meerapur,Rural,379,270,109,270,83,187
8,110,78,79057,0,0,RAJASTHAN,Jaipur,VILLAGE,Dwarikapura,Rural,1132,703,429,774,286,488
8,110,78,79058,0,0,RAJASTHAN,Jaipur,VILLAGE,Jeengor,Rural,1013,594,419,574,259,315
8,110,78,79059,0,0,RAJASTHAN,Jaipur,VILLAGE,Chand Doli,Rural,572,381,191,576,234,342
8,110,78,79060,0,0,RAJASTHAN,Jaipur,VILLAGE,Dudawas,Rural,731,499,232,816,335,481
8,110,78,79061,0,0,RAJASTHAN,Jaipur,VILLAGE,Buchara,Rural,1470,955,515,1312,531,781
8,110,78,79062,0,0,RAJASTHAN,Jaipur,VILLAGE,Rooppura,Rural,917,618,299,877,356,521
8,110,78,79063,0,0,RAJASTHAN,Jaipur,VILLAGE,Fatehpura Khurd,Rural,1118,726,392,787,297,490
8,110,78,79064,0,0,RAJASTHAN,Jaipur,VILLAGE,Bhonawas,Rural,3321,2015,1306,1936,757,1179
8,110,78,79065,0,0,RAJASTHAN,Jaipur,VILLAGE,Torda Goojran,Rural,2046,1338,708,1841,716,1125
8,110,78,79066,0,0,RAJASTHAN,Jaipur,VILLAGE,Taskola,Rural,2370,1489,881,1854,695,1159
8,110,78,79067,0,0,RAJASTHAN,Jaipur,VILLAGE,Panditpura,Rural,935,559,376,543,210,333
8,110,78,79068,0,0,RAJASTHAN,Jaipur,VILLAGE,Gandhi Nagar,Rural,343,235,108,332,126,206
8,110,78,79069,0,0,RAJASTHAN,Jaipur,VILLAGE,Rampura,Rural,1521,1032,489,1117,388,729
8,110,78,79070,0,0,RAJASTHAN,Jaipur,VILLAGE,Bhuree Bharaj,Rural,3693,2495,1198,3801,1468,2333
8,110,78,79071,0,0,RAJASTHAN,Jaipur,VILLAGE,Sujatnagar,Rural,1259,762,497,798,304,494
8,110,78,79072,0,0,RAJASTHAN,Jaipur,VILLAGE,Beethloda,Rural,950,601,349,869,348,521
8,110,78,79073,0,0,RAJASTHAN,Jaipur,VILLAGE,Pawana Aheer,Rural,2112,1316,796,1188,452,736
8,110,78,79074,0,0,RAJASTHAN,Jaipur,VILLAGE,Fatehpura Kalan,Rural,1593,1014,579,916,328,588
8,110,78,79075,0,0,RAJASTHAN,Jaipur,VILLAGE,Saroond,Rural,3366,2080,1286,1980,743,1237
8,110,78,79076,0,0,RAJASTHAN,Jaipur,VILLAGE,Bhojawas,Rural,526,337,189,293,108,185
8,110,78,79077,0,0,RAJASTHAN,Jaipur,VILLAGE,Jagdishpura,Rural,800,490,310,394,148,246
8,110,78,79078,0,0,RAJASTHAN,Jaipur,VILLAGE,Khera Nihalpura,Rural,1629,985,644,1319,579,740
8,110,78,79079,0,0,RAJASTHAN,Jaipur,VILLAGE,Navrangpura,Rural,697,468,229,662,249,413
8,110,78,79080,0,0,RAJASTHAN,Jaipur,VILLAGE,Chanchaki,Rural,419,264,155,292,112,180
8,110,78,79081,0,0,RAJASTHAN,Jaipur,VILLAGE,Shyamnagar,Rural,833,504,329,508,192,316
8,110,78,79082,0,0,RAJASTHAN,Jaipur,VILLAGE,Tapri,Rural,920,614,306,1096,422,674
8,110,78,79083,0,0,RAJASTHAN,Jaipur,VILLAGE,Barabas (Rural),Rural,1268,788,480,767,259,508
8,110,78,79084,0,0,RAJASTHAN,Jaipur,VILLAGE,Basri (Rural),Rural,2430,1472,958,1426,534,892
8,110,78,79085,0,0,RAJASTHAN,Jaipur,VILLAGE,Chaturbhuj,Rural,597,356,241,324,127,197
8,110,78,79086,0,0,RAJASTHAN,Jaipur,VILLAGE,Balawas (Rural),Rural,77,43,34,72,28,44
8,110,78,79087,0,0,RAJASTHAN,Jaipur,VILLAGE,Buchahera (Rural),Rural,701,444,257,476,179,297
8,110,78,79088,0,0,RAJASTHAN,Jaipur,VILLAGE,Bamanwas,Rural,817,498,319,653,273,380
8,110,78,79089,0,0,RAJASTHAN,Jaipur,VILLAGE,Gopipura,Rural,864,567,297,834,349,485
8,110,78,79090,0,0,RAJASTHAN,Jaipur,VILLAGE,Nangal Panditpura,Rural,1243,810,433,1350,536,814
8,110,78,79091,0,0,RAJASTHAN,Jaipur,VILLAGE,Hansiyawas,Rural,459,328,131,667,280,387
8,110,78,79092,0,0,RAJASTHAN,Jaipur,VILLAGE,Tamoriwas,Rural,521,320,201,349,149,200
8,110,78,79093,0,0,RAJASTHAN,Jaipur,VILLAGE,Nagriwas,Rural,451,297,154,480,191,289
8,110,78,79094,0,0,RAJASTHAN,Jaipur,VILLAGE,Jahidpura,Rural,589,389,200,500,186,314
8,110,78,79095,0,0,RAJASTHAN,Jaipur,VILLAGE,Pejooka,Rural,779,509,270,684,266,418
8,110,78,79096,0,0,RAJASTHAN,Jaipur,VILLAGE,Basai,Rural,1317,822,495,963,383,580
8,110,78,79097,0,0,RAJASTHAN,Jaipur,VILLAGE,Bhaloji,Rural,1328,834,494,882,332,550
8,110,78,79098,0,0,RAJASTHAN,Jaipur,VILLAGE,Khurdi,Rural,1132,673,459,688,274,414
8,110,78,79099,0,0,RAJASTHAN,Jaipur,VILLAGE,Amai,Rural,2535,1494,1041,1434,554,880
8,110,78,79100,0,0,RAJASTHAN,Jaipur,VILLAGE,Pootli,Rural,1354,921,433,1089,402,687
8,110,78,79101,0,0,RAJASTHAN,Jaipur,VILLAGE,Sundarpura,Rural,1919,1242,677,1652,644,1008
8,110,78,79102,0,0,RAJASTHAN,Jaipur,VILLAGE,Kiratpura,Rural,641,403,238,418,159,259
8,110,78,79103,0,0,RAJASTHAN,Jaipur,VILLAGE,Kansli,Rural,1976,1148,828,698,249,449
8,110,78,79104,0,0,RAJASTHAN,Jaipur,VILLAGE,Rahera,Rural,569,334,235,369,149,220
8,110,78,79105,0,0,RAJASTHAN,Jaipur,VILLAGE,Kalyanpura Khurd,Rural,1464,952,512,1038,360,678
8,110,78,79106,0,0,RAJASTHAN,Jaipur,VILLAGE,Kanwarpura,Rural,1534,917,617,735,267,468
8,110,78,79107,0,0,RAJASTHAN,Jaipur,VILLAGE,Mohanpura,Rural,1830,1027,803,691,259,432
8,110,78,79108,0,0,RAJASTHAN,Jaipur,VILLAGE,Mahrampur Rajput,Rural,630,396,234,403,149,254
8,110,78,79109,0,0,RAJASTHAN,Jaipur,VILLAGE,Ajeetpura Kalan,Rural,1111,712,399,780,297,483
8,110,78,79110,0,0,RAJASTHAN,Jaipur,VILLAGE,Bhainslana,Rural,3260,2039,1221,1929,715,1214
8,110,78,79111,0,0,RAJASTHAN,Jaipur,VILLAGE,Koojota,Rural,2289,1388,901,1274,471,803
8,110,78,79112,0,0,RAJASTHAN,Jaipur,VILLAGE,Mahrampur Nawab,Rural,861,509,352,418,179,239
8,110,78,79113,0,0,RAJASTHAN,Jaipur,VILLAGE,Gordhanpura,Rural,2594,1585,1009,1604,612,992
8,110,78,79114,0,0,RAJASTHAN,Jaipur,VILLAGE,Daduka,Rural,1849,1148,701,1326,522,804
8,110,78,79115,0,0,RAJASTHAN,Jaipur,VILLAGE,Pathreri,Rural,3202,1990,1212,2274,863,1411
8,110,78,79116,0,0,RAJASTHAN,Jaipur,VILLAGE,Rughnathpura,Rural,1015,608,407,578,208,370
8,110,78,79117,0,0,RAJASTHAN,Jaipur,VILLAGE,Aspura,Rural,865,553,312,537,198,339
8,110,78,79121,0,0,RAJASTHAN,Jaipur,VILLAGE,Manjukot,Rural,726,423,303,354,139,215
8,110,78,79122,0,0,RAJASTHAN,Jaipur,VILLAGE,Kakrana,Rural,371,239,132,253,85,168
8,110,78,79137,0,0,RAJASTHAN,Jaipur,VILLAGE,Rajnauta,Rural,3053,1901,1152,1822,708,1114
8,110,78,79138,0,0,RAJASTHAN,Jaipur,VILLAGE,Bheevji,Rural,1308,784,524,706,310,396
8,110,78,79139,0,0,RAJASTHAN,Jaipur,VILLAGE,Lunaji,Rural,1246,782,464,792,321,471
8,110,78,79140,0,0,RAJASTHAN,Jaipur,VILLAGE,Karaudi,Rural,1140,682,458,493,197,296
8,110,78,79141,0,0,RAJASTHAN,Jaipur,VILLAGE,Karoli,Rural,3578,2202,1376,2467,1012,1455
8,110,79,0,0,0,RAJASTHAN,Jaipur,CD BLOCK,Viratnagar ,Total,141673,90827,50846,113682,43057,70625
8,110,79,0,0,0,RAJASTHAN,Jaipur,CD BLOCK,Viratnagar ,Rural,141673,90827,50846,113682,43057,70625
8,110,79,0,0,0,RAJASTHAN,Jaipur,CD BLOCK,Viratnagar ,Urban,0,0,0,0,0,0
8,110,79,79118,0,0,RAJASTHAN,Jaipur,VILLAGE,Kirarod,Rural,1638,1040,598,971,348,623
8,110,79,79119,0,0,RAJASTHAN,Jaipur,VILLAGE,Pragpura,Rural,7553,4605,2948,4561,1700,2861
8,110,79,79120,0,0,RAJASTHAN,Jaipur,VILLAGE,Lalana,Rural,1188,746,442,918,345,573
8,110,79,79123,0,0,RAJASTHAN,Jaipur,VILLAGE,Paota,Rural,10044,6027,4017,5429,2092,3337
8,110,79,79124,0,0,RAJASTHAN,Jaipur,VILLAGE,Shiv Nagar,Rural,841,533,308,813,319,494
8,110,79,79125,0,0,RAJASTHAN,Jaipur,VILLAGE,Kooner,Rural,1108,678,430,576,210,366
8,110,79,79126,0,0,RAJASTHAN,Jaipur,VILLAGE,Khelna,Rural,3180,2073,1107,2431,909,1522
8,110,79,79127,0,0,RAJASTHAN,Jaipur,VILLAGE,Ladakawas,Rural,1554,936,618,1156,470,686
8,110,79,79128,0,0,RAJASTHAN,Jaipur,VILLAGE,Theekariya,Rural,1765,1115,650,1533,577,956
8,110,79,79129,0,0,RAJASTHAN,Jaipur,VILLAGE,Tordabrahmanan,Rural,1055,679,376,879,324,555
8,110,79,79130,0,0,RAJASTHAN,Jaipur,VILLAGE,Tulsipura,Rural,1075,709,366,751,274,477
8,110,79,79131,0,0,RAJASTHAN,Jaipur,VILLAGE,Gurha,Rural,333,203,130,191,72,119
8,110,79,79132,0,0,RAJASTHAN,Jaipur,VILLAGE,Barnagar,Rural,5867,3640,2227,3830,1465,2365
8,110,79,79133,0,0,RAJASTHAN,Jaipur,VILLAGE,Kalyanpura,Rural,798,510,288,608,234,374
8,110,79,79134,0,0,RAJASTHAN,Jaipur,VILLAGE,Jodhpura,Rural,1271,808,463,962,338,624
8,110,79,79135,0,0,RAJASTHAN,Jaipur,VILLAGE,Bhankhari,Rural,4509,2935,1574,3519,1268,2251
8,110,79,79136,0,0,RAJASTHAN,Jaipur,VILLAGE,Mandha,Rural,3684,2303,1381,3148,1243,1905
8,110,79,79142,0,0,RAJASTHAN,Jaipur,VILLAGE,Panch Pahari,Rural,1253,735,518,972,391,581
8,110,79,79143,0,0,RAJASTHAN,Jaipur,VILLAGE,Pachhodala,Rural,3407,2162,1245,3316,1383,1933
8,110,79,79144,0,0,RAJASTHAN,Jaipur,VILLAGE,Neemli,Rural,506,350,156,548,227,321
8,110,79,79145,0,0,RAJASTHAN,Jaipur,VILLAGE,Bajrangpura,Rural,1514,960,554,1211,457,754
8,110,79,79146,0,0,RAJASTHAN,Jaipur,VILLAGE,Rampura Khurd,Rural,555,363,192,382,154,228
8,110,79,79147,0,0,RAJASTHAN,Jaipur,VILLAGE,Shyolal Pura,Rural,235,144,91,297,117,180
8,110,79,79148,0,0,RAJASTHAN,Jaipur,VILLAGE,Kairli,Rural,1359,865,494,1155,442,713
8,110,79,79149,0,0,RAJASTHAN,Jaipur,VILLAGE,Hanuman Nagar,Rural,602,378,224,416,157,259
8,110,79,79150,0,0,RAJASTHAN,Jaipur,VILLAGE,Ram Nagar,Rural,267,156,111,168,64,104
8,110,79,79151,0,0,RAJASTHAN,Jaipur,VILLAGE,Antela,Rural,2947,1824,1123,1862,714,1148
8,110,79,79152,0,0,RAJASTHAN,Jaipur,VILLAGE,Gandhi Nagar,Rural,710,474,236,665,251,414
8,110,79,79153,0,0,RAJASTHAN,Jaipur,VILLAGE,Bahdoda,Rural,293,182,111,278,111,167
8,110,79,79154,0,0,RAJASTHAN,Jaipur,VILLAGE,Neelka,Rural,526,336,190,402,162,240
8,110,79,79155,0,0,RAJASTHAN,Jaipur,VILLAGE,Dhani Gaiskan,Rural,1495,917,578,1070,417,653
8,110,79,79156,0,0,RAJASTHAN,Jaipur,VILLAGE,Bhabroo,Rural,4005,2604,1401,3319,1250,2069
8,110,79,79157,0,0,RAJASTHAN,Jaipur,VILLAGE,Dera,Rural,182,131,51,214,82,132
8,110,79,79158,0,0,RAJASTHAN,Jaipur,VILLAGE,Dolyapur,Rural,613,340,273,266,118,148
8,110,79,79159,0,0,RAJASTHAN,Jaipur,VILLAGE,Sitapur,Rural,565,351,214,594,241,353
8,110,79,79160,0,0,RAJASTHAN,Jaipur,VILLAGE,Luhakana Kalan,Rural,1432,895,537,1035,388,647
8,110,79,79161,0,0,RAJASTHAN,Jaipur,VILLAGE,Luhakana Khurd,Rural,1306,761,545,681,265,416
8,110,79,79162,0,0,RAJASTHAN,Jaipur,VILLAGE,Dhoolkot,Rural,558,344,214,319,129,190
8,110,79,79163,0,0,RAJASTHAN,Jaipur,VILLAGE,Kishanpura,Rural,840,540,300,711,260,451
8,110,79,79164,0,0,RAJASTHAN,Jaipur,VILLAGE,Banipark,Rural,666,426,240,567,226,341
8,110,79,79165,0,0,RAJASTHAN,Jaipur,VILLAGE,Bagawas Ahiran,Rural,1744,1096,648,1294,512,782
8,110,79,79166,0,0,RAJASTHAN,Jaipur,VILLAGE,Taliyara,Rural,689,440,249,596,207,389
8,110,79,79167,0,0,RAJASTHAN,Jaipur,VILLAGE,Bhagatpura,Rural,625,394,231,576,236,340
8,110,79,79168,0,0,RAJASTHAN,Jaipur,VILLAGE,Jaisinghpura,Rural,1806,1172,634,1473,566,907
8,110,79,79169,0,0,RAJASTHAN,Jaipur,VILLAGE,Surajpura,Rural,964,584,380,628,237,391
8,110,79,79170,0,0,RAJASTHAN,Jaipur,VILLAGE,Bahadurpura,Rural,806,488,318,489,182,307
8,110,79,79171,0,0,RAJASTHAN,Jaipur,VILLAGE,Chheetoli,Rural,1295,806,489,964,381,583
8,110,79,79172,0,0,RAJASTHAN,Jaipur,VILLAGE,Devipura @ Baniya Ka Bas,Rural,271,182,89,328,124,204
8,110,79,79173,0,0,RAJASTHAN,Jaipur,VILLAGE,Bahrampur,Rural,131,86,45,119,44,75
8,110,79,79174,0,0,RAJASTHAN,Jaipur,VILLAGE,Jadoo Ka Bas,Rural,202,137,65,193,73,120
8,110,79,79175,0,0,RAJASTHAN,Jaipur,VILLAGE,Bhojpura @ Lakhawala,Rural,693,505,188,821,293,528
8,110,79,79176,0,0,RAJASTHAN,Jaipur,VILLAGE,Rughnathpura @ Taloo Ka Bas,Rural,429,307,122,567,235,332
8,110,79,79177,0,0,RAJASTHAN,Jaipur,VILLAGE,Deoli,Rural,825,557,268,967,368,599
8,110,79,79178,0,0,RAJASTHAN,Jaipur,VILLAGE,Badshahpur,Rural,286,189,97,354,143,211
8,110,79,79179,0,0,RAJASTHAN,Jaipur,VILLAGE,Sothana,Rural,455,338,117,508,189,319
8,110,79,79180,0,0,RAJASTHAN,Jaipur,VILLAGE,Kankrana Chhota,Rural,456,314,142,485,199,286
8,110,79,79181,0,0,RAJASTHAN,Jaipur,VILLAGE,Kankrana Bara,Rural,381,267,114,381,141,240
8,110,79,79182,0,0,RAJASTHAN,Jaipur,VILLAGE,Papra,Rural,1019,686,333,1111,413,698
8,110,79,79183,0,0,RAJASTHAN,Jaipur,VILLAGE,Chak Kharda,Rural,269,164,105,166,52,114
8,110,79,79184,0,0,RAJASTHAN,Jaipur,VILLAGE,Kuhada,Rural,1144,775,369,1106,410,696
8,110,79,79185,0,0,RAJASTHAN,Jaipur,VILLAGE,Bandh Muzaffarpur,Rural,389,275,114,470,191,279
8,110,79,79186,0,0,RAJASTHAN,Jaipur,VILLAGE,Chak Muzaffarpur,Rural,20,12,8,17,6,11
8,110,79,79187,0,0,RAJASTHAN,Jaipur,VILLAGE,Chak Gorawari,Rural,24,17,7,50,24,26
8,110,79,79188,0,0,RAJASTHAN,Jaipur,VILLAGE,Ismailpur,Rural,407,240,167,331,119,212
8,110,79,79189,0,0,RAJASTHAN,Jaipur,VILLAGE,Mahasingh Ka Bas,Rural,588,383,205,473,171,302
8,110,79,79190,0,0,RAJASTHAN,Jaipur,VILLAGE,Sujapur,Rural,61,41,20,70,30,40
8,110,79,79191,0,0,RAJASTHAN,Jaipur,VILLAGE,Chak Chamroli,Rural,35,22,13,25,8,17
8,110,79,79192,0,0,RAJASTHAN,Jaipur,VILLAGE,Gopipur,Rural,117,79,38,131,51,80
8,110,79,79193,0,0,RAJASTHAN,Jaipur,VILLAGE,Papri,Rural,1308,816,492,992,407,585
8,110,79,79194,0,0,RAJASTHAN,Jaipur,VILLAGE,Biyawas,Rural,1173,785,388,1365,528,837
8,110,79,79195,0,0,RAJASTHAN,Jaipur,VILLAGE,Dhobiyawali,Rural,424,258,166,376,161,215
8,110,79,79196,0,0,RAJASTHAN,Jaipur,VILLAGE,Chatarpura,Rural,876,545,331,563,217,346
8,110,79,79197,0,0,RAJASTHAN,Jaipur,VILLAGE,Jawanpura,Rural,1150,715,435,716,250,466
8,110,79,79198,0,0,RAJASTHAN,Jaipur,VILLAGE,Khatolai,Rural,1269,747,522,577,195,382
8,110,79,79199,0,0,RAJASTHAN,Jaipur,VILLAGE,Leelon Ka Bas,Rural,468,299,169,352,127,225
8,110,79,79200,0,0,RAJASTHAN,Jaipur,VILLAGE,Surpura,Rural,561,369,192,390,130,260
8,110,79,79201,0,0,RAJASTHAN,Jaipur,VILLAGE,Jogiyon Ki Dhani,Rural,768,494,274,555,193,362
8,110,79,79202,0,0,RAJASTHAN,Jaipur,VILLAGE,Gurjarpura,Rural,411,268,143,316,117,199
8,110,79,79203,0,0,RAJASTHAN,Jaipur,VILLAGE,Bagawas Chaurasi,Rural,1818,1203,615,1581,570,1011
8,110,79,79204,0,0,RAJASTHAN,Jaipur,VILLAGE,Beelwari,Rural,1652,1060,592,1296,468,828
8,110,79,79205,0,0,RAJASTHAN,Jaipur,VILLAGE,Bas Udaisingh,Rural,331,223,108,276,108,168
8,110,79,79206,0,0,RAJASTHAN,Jaipur,VILLAGE,Dhole Kothi,Rural,504,305,199,463,183,280
8,110,79,79207,0,0,RAJASTHAN,Jaipur,VILLAGE,Kukdela,Rural,564,367,197,382,134,248
8,110,79,79208,0,0,RAJASTHAN,Jaipur,VILLAGE,Khera,Rural,535,369,166,560,210,350
8,110,79,79209,0,0,RAJASTHAN,Jaipur,VILLAGE,Norang Pura,Rural,2090,1380,710,1952,724,1228
8,110,79,79210,0,0,RAJASTHAN,Jaipur,VILLAGE,Bhairunpura,Rural,455,300,155,365,129,236
8,110,79,79211,0,0,RAJASTHAN,Jaipur,VILLAGE,Sewara,Rural,615,441,174,752,279,473
8,110,79,79212,0,0,RAJASTHAN,Jaipur,VILLAGE,Teori,Rural,2001,1345,656,1701,634,1067
8,110,79,79213,0,0,RAJASTHAN,Jaipur,VILLAGE,Gyanpura,Rural,198,144,54,287,115,172
8,110,79,79214,0,0,RAJASTHAN,Jaipur,VILLAGE,Daulaj,Rural,215,138,77,214,79,135
8,110,79,79215,0,0,RAJASTHAN,Jaipur,VILLAGE,Chak Bai Ka Bas,Rural,0,0,0,0,0,0
8,110,79,79216,0,0,RAJASTHAN,Jaipur,VILLAGE,Bhojera,Rural,529,387,142,733,294,439
8,110,79,79217,0,0,RAJASTHAN,Jaipur,VILLAGE,Satana,Rural,692,455,237,490,190,300
8,110,79,79218,0,0,RAJASTHAN,Jaipur,VILLAGE,Jodhoola,Rural,346,255,91,500,189,311
8,110,79,79219,0,0,RAJASTHAN,Jaipur,VILLAGE,Jodhoola Upala,Rural,340,246,94,447,179,268
8,110,79,79220,0,0,RAJASTHAN,Jaipur,VILLAGE,Galawas,Rural,143,95,48,293,131,162
8,110,79,79221,0,0,RAJASTHAN,Jaipur,VILLAGE,Cheend,Rural,289,213,76,459,189,270
8,110,79,79222,0,0,RAJASTHAN,Jaipur,VILLAGE,Maliwara,Rural,445,304,141,552,228,324
8,110,79,79223,0,0,RAJASTHAN,Jaipur,VILLAGE,Poorawala,Rural,534,357,177,519,187,332
8,110,79,79224,0,0,RAJASTHAN,Jaipur,VILLAGE,Med,Rural,5487,3584,1903,4892,1809,3083
8,110,79,79225,0,0,RAJASTHAN,Jaipur,VILLAGE,Shyampura,Rural,1219,777,442,1100,396,704
8,110,79,79226,0,0,RAJASTHAN,Jaipur,VILLAGE,Bhamod,Rural,1237,813,424,950,353,597
8,110,79,79227,0,0,RAJASTHAN,Jaipur,VILLAGE,Pando,Rural,682,468,214,798,315,483
8,110,79,79228,0,0,RAJASTHAN,Jaipur,VILLAGE,Barwara,Rural,516,349,167,497,190,307
8,110,79,79229,0,0,RAJASTHAN,Jaipur,VILLAGE,Palri,Rural,879,611,268,1023,386,637
8,110,79,79230,0,0,RAJASTHAN,Jaipur,VILLAGE,Ramsinghpura,Rural,134,90,44,194,86,108
8,110,79,79231,0,0,RAJASTHAN,Jaipur,VILLAGE,Badodiya,Rural,1299,893,406,1445,529,916
8,110,79,79232,0,0,RAJASTHAN,Jaipur,VILLAGE,Bamanwas,Rural,423,290,133,510,207,303
8,110,79,79233,0,0,RAJASTHAN,Jaipur,VILLAGE,Amloda,Rural,1329,914,415,1200,432,768
8,110,79,79234,0,0,RAJASTHAN,Jaipur,VILLAGE,Kalyanpura,Rural,460,323,137,434,142,292
8,110,79,79235,0,0,RAJASTHAN,Jaipur,VILLAGE,Hari Kishan Pura,Rural,514,338,176,608,224,384
8,110,79,79236,0,0,RAJASTHAN,Jaipur,VILLAGE,Gheota,Rural,421,280,141,390,161,229
8,110,79,79237,0,0,RAJASTHAN,Jaipur,VILLAGE,Bihajar,Rural,441,295,146,419,143,276
8,110,79,79238,0,0,RAJASTHAN,Jaipur,VILLAGE,Bhindor,Rural,315,224,91,307,103,204
8,110,79,79239,0,0,RAJASTHAN,Jaipur,VILLAGE,Shyam Nagar,Rural,307,218,89,330,123,207
8,110,79,79240,0,0,RAJASTHAN,Jaipur,VILLAGE,Sundarpura,Rural,339,239,100,423,174,249
8,110,79,79241,0,0,RAJASTHAN,Jaipur,VILLAGE,Badshah Pur,Rural,196,124,72,158,64,94
8,110,79,79242,0,0,RAJASTHAN,Jaipur,VILLAGE,Gudha Baijnathpura,Rural,170,112,58,215,72,143
8,110,79,79243,0,0,RAJASTHAN,Jaipur,VILLAGE,Beerki,Rural,379,236,143,316,120,196
8,110,79,79244,0,0,RAJASTHAN,Jaipur,VILLAGE,Talva,Rural,585,423,162,1090,480,610
8,110,79,79245,0,0,RAJASTHAN,Jaipur,VILLAGE,Aspura,Rural,707,456,251,497,185,312
8,110,79,79246,0,0,RAJASTHAN,Jaipur,VILLAGE,Chhapra Khurd,Rural,1620,1098,522,1259,443,816
8,110,79,79247,0,0,RAJASTHAN,Jaipur,VILLAGE,Chhapra Kalan,Rural,1939,1285,654,1411,528,883
8,110,79,79248,0,0,RAJASTHAN,Jaipur,VILLAGE,Basri Ganeshpura,Rural,430,290,140,443,180,263
8,110,79,79249,0,0,RAJASTHAN,Jaipur,VILLAGE,Neejhar,Rural,647,418,229,467,169,298
8,110,79,79250,0,0,RAJASTHAN,Jaipur,VILLAGE,Jawanpura Dhabai,Rural,445,315,130,649,247,402
8,110,79,79251,0,0,RAJASTHAN,Jaipur,VILLAGE,Govindpura Dhabai,Rural,897,613,284,803,299,504
8,110,79,79252,0,0,RAJASTHAN,Jaipur,VILLAGE,Satwas,Rural,193,126,67,132,46,86
8,110,79,79253,0,0,RAJASTHAN,Jaipur,VILLAGE,Jaje Kalan,Rural,2232,1454,778,1566,537,1029
8,110,79,79254,0,0,RAJASTHAN,Jaipur,VILLAGE,Rampura,Rural,2105,1344,761,1273,424,849
8,110,79,79255,0,0,RAJASTHAN,Jaipur,VILLAGE,Girdharpura,Rural,395,260,135,213,78,135
8,110,79,79261,0,0,RAJASTHAN,Jaipur,VILLAGE,Gautam Nagar,Rural,597,350,247,229,68,161
8,110,80,0,0,0,RAJASTHAN,Jaipur,CD BLOCK,Shahpura,Total,128760,81708,47052,88828,32630,56198
8,110,80,0,0,0,RAJASTHAN,Jaipur,CD BLOCK,Shahpura,Rural,116390,74180,42210,80911,29556,51355
8,110,80,0,0,0,RAJASTHAN,Jaipur,CD BLOCK,Shahpura,Urban,12370,7528,4842,7917,3074,4843
8,110,80,79256,0,0,RAJASTHAN,Jaipur,VILLAGE,Sanga Ka Bas,Rural,190,121,69,111,35,76
8,110,80,79257,0,0,RAJASTHAN,Jaipur,VILLAGE,Ramchandra Pura,Rural,631,396,235,384,136,248
8,110,80,79258,0,0,RAJASTHAN,Jaipur,VILLAGE,Barijori,Rural,2653,1697,956,1604,550,1054
8,110,80,79259,0,0,RAJASTHAN,Jaipur,VILLAGE,Jaswant Pura,Rural,771,488,283,396,139,257
8,110,80,79260,0,0,RAJASTHAN,Jaipur,VILLAGE,Chak Sanga Ka Bas,Rural,119,75,44,77,22,55
8,110,80,79262,0,0,RAJASTHAN,Jaipur,VILLAGE,Karni Sagar,Rural,1009,659,350,679,218,461
8,110,80,79263,0,0,RAJASTHAN,Jaipur,VILLAGE,Rughnath Pura,Rural,578,385,193,512,196,316
8,110,80,79264,0,0,RAJASTHAN,Jaipur,VILLAGE,Saiwar,Rural,3158,1974,1184,1781,672,1109
8,110,80,79265,0,0,RAJASTHAN,Jaipur,VILLAGE,Chimanpura,Rural,890,577,313,563,197,366
8,110,80,79266,0,0,RAJASTHAN,Jaipur,VILLAGE,Nathawala,Rural,2573,1624,949,1480,495,985
8,110,80,79267,0,0,RAJASTHAN,Jaipur,VILLAGE,Amarpura,Rural,807,502,305,508,187,321
8,110,80,79268,0,0,RAJASTHAN,Jaipur,VILLAGE,Swamipura,Rural,503,338,165,451,158,293
8,110,80,79269,0,0,RAJASTHAN,Jaipur,VILLAGE,Bhanipura,Rural,656,417,239,271,90,181
8,110,80,79270,0,0,RAJASTHAN,Jaipur,VILLAGE,Devipura,Rural,1230,768,462,681,242,439
8,110,80,79271,0,0,RAJASTHAN,Jaipur,VILLAGE,Bichpari,Rural,252,174,78,271,116,155
8,110,80,79272,0,0,RAJASTHAN,Jaipur,VILLAGE,Pathano Ka Bas,Rural,999,639,360,676,256,420
8,110,80,79273,0,0,RAJASTHAN,Jaipur,VILLAGE,Amarsar,Rural,3881,2384,1497,2047,709,1338
8,110,80,79274,0,0,RAJASTHAN,Jaipur,VILLAGE,Patel Nagar,Rural,633,393,240,301,113,188
8,110,80,79275,0,0,RAJASTHAN,Jaipur,VILLAGE,Nayan,Rural,2741,1714,1027,1556,555,1001
8,110,80,79276,0,0,RAJASTHAN,Jaipur,VILLAGE,Kalwaniyon Ka Bas,Rural,1215,821,394,962,376,586
8,110,80,79277,0,0,RAJASTHAN,Jaipur,VILLAGE,Gopalpura,Rural,458,300,158,202,65,137
8,110,80,79278,0,0,RAJASTHAN,Jaipur,VILLAGE,Ranipura,Rural,849,539,310,522,182,340
8,110,80,79279,0,0,RAJASTHAN,Jaipur,VILLAGE,Trilok Pura,Rural,1048,633,415,650,251,399
8,110,80,79280,0,0,RAJASTHAN,Jaipur,VILLAGE,Jodhpura,Rural,623,400,223,481,184,297
8,110,80,79281,0,0,RAJASTHAN,Jaipur,VILLAGE,Hanutpura,Rural,2769,1726,1043,1596,538,1058
8,110,80,79282,0,0,RAJASTHAN,Jaipur,VILLAGE,Chak Hanutpura,Rural,142,95,47,94,36,58
8,110,80,79283,0,0,RAJASTHAN,Jaipur,VILLAGE,Kareeri,Rural,5379,3368,2011,3687,1397,2290
8,110,80,79284,0,0,RAJASTHAN,Jaipur,VILLAGE,Bilandarpur,Rural,4812,2944,1868,3081,1171,1910
8,110,80,79285,0,0,RAJASTHAN,Jaipur,VILLAGE,Chak Dhanota,Rural,468,305,163,316,106,210
8,110,80,79286,0,0,RAJASTHAN,Jaipur,VILLAGE,Govindpura Basri,Rural,2159,1391,768,1491,518,973
8,110,80,79287,0,0,RAJASTHAN,Jaipur,VILLAGE,Raopura,Rural,1463,901,562,958,365,593
8,110,80,79288,0,0,RAJASTHAN,Jaipur,VILLAGE,Dhanota,Rural,3754,2284,1470,2073,798,1275
8,110,80,79289,0,0,RAJASTHAN,Jaipur,VILLAGE,Murli Pura,Rural,1231,811,420,1018,342,676
8,110,80,79290,0,0,RAJASTHAN,Jaipur,VILLAGE,Kalyanpura,Rural,955,617,338,671,222,449
8,110,80,79291,0,0,RAJASTHAN,Jaipur,VILLAGE,Markhi,Rural,769,494,275,642,252,390
8,110,80,79292,0,0,RAJASTHAN,Jaipur,VILLAGE,Hanutiya,Rural,641,403,238,502,200,302
8,110,80,79293,0,0,RAJASTHAN,Jaipur,VILLAGE,Tejpura,Rural,739,465,274,450,158,292
8,110,80,79294,0,0,RAJASTHAN,Jaipur,VILLAGE,Radawas,Rural,3656,2245,1411,2761,1055,1706
8,110,80,79295,0,0,RAJASTHAN,Jaipur,VILLAGE,Jagatpura,Rural,1419,872,547,900,303,597
8,110,80,79296,0,0,RAJASTHAN,Jaipur,VILLAGE,Majeepura,Rural,1084,679,405,621,208,413
8,110,80,79297,0,0,RAJASTHAN,Jaipur,VILLAGE,Mahar Khurd,Rural,1284,811,473,1048,417,631
8,110,80,79298,0,0,RAJASTHAN,Jaipur,VILLAGE,Parman Pura,Rural,1165,728,437,631,207,424
8,110,80,79299,0,0,RAJASTHAN,Jaipur,VILLAGE,Gulab Bari,Rural,1306,876,430,890,298,592
8,110,80,79300,0,0,RAJASTHAN,Jaipur,VILLAGE,Amloda,Rural,1309,814,495,790,288,502
8,110,80,79301,0,0,RAJASTHAN,Jaipur,VILLAGE,Shyosinghpura,Rural,1280,827,453,997,349,648
8,110,80,79302,0,0,RAJASTHAN,Jaipur,VILLAGE,Dhaoli,Rural,1855,1129,726,1289,539,750
8,110,80,79303,0,0,RAJASTHAN,Jaipur,VILLAGE,Sepatpura,Rural,747,497,250,591,203,388
8,110,80,79304,0,0,RAJASTHAN,Jaipur,VILLAGE,Nayabas,Rural,2025,1281,744,1157,393,764
8,110,80,79305,0,0,RAJASTHAN,Jaipur,VILLAGE,Gailadera,Rural,93,64,29,81,30,51
8,110,80,79306,0,0,RAJASTHAN,Jaipur,VILLAGE,Gonakasar,Rural,517,336,181,455,151,304
8,110,80,79307,0,0,RAJASTHAN,Jaipur,VILLAGE,Mamtori Khurd,Rural,688,471,217,680,242,438
8,110,80,79308,0,0,RAJASTHAN,Jaipur,VILLAGE,Mamtori Kalan,Rural,829,593,236,868,309,559
8,110,80,79309,0,0,RAJASTHAN,Jaipur,VILLAGE,Gonpur @ Dangyawali,Rural,149,109,40,159,60,99
8,110,80,79310,0,0,RAJASTHAN,Jaipur,VILLAGE,Vishan Garh,Rural,2977,1918,1059,2499,965,1534
8,110,80,79311,0,0,RAJASTHAN,Jaipur,VILLAGE,Peeplod Nathu,Rural,348,259,89,443,167,276
8,110,80,79312,0,0,RAJASTHAN,Jaipur,VILLAGE,Peeplod Narain,Rural,549,375,174,540,185,355
8,110,80,79313,0,0,RAJASTHAN,Jaipur,VILLAGE,Dhelawas,Rural,143,95,48,147,59,88
8,110,80,79314,0,0,RAJASTHAN,Jaipur,VILLAGE,Chatarpura,Rural,490,344,146,593,216,377
8,110,80,79315,0,0,RAJASTHAN,Jaipur,VILLAGE,Khori,Rural,3374,2185,1189,2398,875,1523
8,110,80,79316,0,0,RAJASTHAN,Jaipur,VILLAGE,Sherpura,Rural,1045,688,357,868,317,551
8,110,80,79317,0,0,RAJASTHAN,Jaipur,VILLAGE,Ghasipura,Rural,1206,767,439,816,304,512
8,110,80,79318,0,0,RAJASTHAN,Jaipur,VILLAGE,Khojawala,Rural,667,436,231,486,170,316
8,110,80,79319,0,0,RAJASTHAN,Jaipur,VILLAGE,Bawari Ki Dhani,Rural,547,344,203,407,164,243
8,110,80,79320,0,0,RAJASTHAN,Jaipur,VILLAGE,Vidara (Rural),Rural,1744,1123,621,988,372,616
8,110,80,79321,0,0,RAJASTHAN,Jaipur,VILLAGE,Rajpura,Rural,1683,1072,611,1037,352,685
8,110,80,79322,0,0,RAJASTHAN,Jaipur,VILLAGE,Let Ka Bas,Rural,1691,1071,620,1171,440,731
8,110,80,79323,0,0,RAJASTHAN,Jaipur,VILLAGE,Lakhni,Rural,924,597,327,592,203,389
8,110,80,79324,0,0,RAJASTHAN,Jaipur,VILLAGE,Kant,Rural,2017,1296,721,1424,502,922
8,110,80,79325,0,0,RAJASTHAN,Jaipur,VILLAGE,Madho Ka Bas,Rural,755,487,268,658,234,424
8,110,80,79326,0,0,RAJASTHAN,Jaipur,VILLAGE,Lobrawas,Rural,311,210,101,314,108,206
8,110,80,79327,0,0,RAJASTHAN,Jaipur,VILLAGE,Devan,Rural,3804,2479,1325,2853,1005,1848
8,110,80,79328,0,0,RAJASTHAN,Jaipur,VILLAGE,Kumbhawas,Rural,897,602,295,1086,439,647
8,110,80,79329,0,0,RAJASTHAN,Jaipur,VILLAGE,Nithara,Rural,1450,927,523,963,334,629
8,110,80,79330,0,0,RAJASTHAN,Jaipur,VILLAGE,Lochu Ka Was,Rural,752,461,291,369,120,249
8,110,80,79331,0,0,RAJASTHAN,Jaipur,VILLAGE,Udawala,Rural,1546,910,636,989,385,604
8,110,80,79332,0,0,RAJASTHAN,Jaipur,VILLAGE,Badigaron Ki Dhani,Rural,367,252,115,322,115,207
8,110,80,79333,0,0,RAJASTHAN,Jaipur,VILLAGE,Mishrawas,Rural,311,219,92,324,131,193
8,110,80,79334,0,0,RAJASTHAN,Jaipur,VILLAGE,Kalyanpura,Rural,804,530,274,690,271,419
8,110,80,79335,0,0,RAJASTHAN,Jaipur,VILLAGE,Pratappura,Rural,604,396,208,497,167,330
8,110,80,79336,0,0,RAJASTHAN,Jaipur,VILLAGE,Nawalpura,Rural,1936,1261,675,1747,683,1064
8,110,80,79337,0,0,RAJASTHAN,Jaipur,VILLAGE,Shivpuri,Rural,618,416,202,557,221,336
8,110,80,79338,0,0,RAJASTHAN,Jaipur,VILLAGE,Bhikhawala,Rural,508,330,178,363,136,227
8,110,80,79339,0,0,RAJASTHAN,Jaipur,VILLAGE,Todi,Rural,892,607,285,837,339,498
8,110,80,79340,0,0,RAJASTHAN,Jaipur,VILLAGE,Chharsa,Rural,2187,1400,787,1419,515,904
8,110,80,79341,0,0,RAJASTHAN,Jaipur,VILLAGE,Surana,Rural,1674,1108,566,1416,526,890
8,110,80,79342,0,0,RAJASTHAN,Jaipur,VILLAGE,Shakatpura,Rural,418,277,141,425,158,267
8,110,80,79343,0,0,RAJASTHAN,Jaipur,VILLAGE,Khora Lardhani,Rural,2798,1813,985,2111,761,1350
8,110,80,79344,0,0,RAJASTHAN,Jaipur,VILLAGE,Hanutpura,Rural,1199,771,428,899,318,581
8,110,80,79345,0,0,RAJASTHAN,Jaipur,TOWN,Manoharpur (CT),Urban,12370,7528,4842,7917,3074,4843
8,110,81,0,0,0,RAJASTHAN,Jaipur,CD BLOCK,Govindgarh,Total,201629,124875,76754,128963,46942,82021
8,110,81,0,0,0,RAJASTHAN,Jaipur,CD BLOCK,Govindgarh,Rural,196322,121825,74497,126535,46032,80503
8,110,81,0,0,0,RAJASTHAN,Jaipur,CD BLOCK,Govindgarh,Urban,5307,3050,2257,2428,910,1518
8,110,81,79346,0,0,RAJASTHAN,Jaipur,VILLAGE,Bagri,Rural,852,543,309,565,205,360
8,110,81,79347,0,0,RAJASTHAN,Jaipur,VILLAGE,Sirsa,Rural,1135,731,404,575,183,392
8,110,81,79348,0,0,RAJASTHAN,Jaipur,VILLAGE,Ranjeetpura,Rural,911,586,325,507,163,344
8,110,81,79349,0,0,RAJASTHAN,Jaipur,VILLAGE,Nangal Govind,Rural,1290,823,467,890,332,558
8,110,81,79350,0,0,RAJASTHAN,Jaipur,VILLAGE,Kishanpura,Rural,3201,2013,1188,1888,723,1165
8,110,81,79351,0,0,RAJASTHAN,Jaipur,VILLAGE,Haboo Ka Bas,Rural,334,198,136,190,69,121
8,110,81,79352,0,0,RAJASTHAN,Jaipur,VILLAGE,Bagron Ka Bas,Rural,667,371,296,430,186,244
8,110,81,79353,0,0,RAJASTHAN,Jaipur,VILLAGE,Asti Kalan,Rural,2377,1450,927,1701,582,1119
8,110,81,79354,0,0,RAJASTHAN,Jaipur,VILLAGE,Asti Khurd,Rural,999,644,355,667,241,426
8,110,81,79355,0,0,RAJASTHAN,Jaipur,VILLAGE,Geeda Ka Bas,Rural,452,266,186,245,70,175
8,110,81,79356,0,0,RAJASTHAN,Jaipur,VILLAGE,Bhutera,Rural,1882,1151,731,1302,460,842
8,110,81,79357,0,0,RAJASTHAN,Jaipur,VILLAGE,Cheta Ka Bas,Rural,278,169,109,276,110,166
8,110,81,79358,0,0,RAJASTHAN,Jaipur,VILLAGE,Heera Ka Bas,Rural,509,293,216,301,118,183
8,110,81,79359,0,0,RAJASTHAN,Jaipur,VILLAGE,Madho Ka Bas,Rural,93,64,29,62,18,44
8,110,81,79360,0,0,RAJASTHAN,Jaipur,VILLAGE,Udgwar @ Gudalya,Rural,1914,1177,737,1100,369,731
8,110,81,79361,0,0,RAJASTHAN,Jaipur,VILLAGE,Chhota Gudha,Rural,735,449,286,622,235,387
8,110,81,79362,0,0,RAJASTHAN,Jaipur,VILLAGE,Kirat Singh Ka Bas,Rural,613,386,227,457,163,294
8,110,81,79363,0,0,RAJASTHAN,Jaipur,VILLAGE,Nangal Kalan,Rural,2006,1230,776,1294,457,837
8,110,81,79364,0,0,RAJASTHAN,Jaipur,VILLAGE,Raisingh Ka Bas,Rural,819,512,307,533,192,341
8,110,81,79365,0,0,RAJASTHAN,Jaipur,VILLAGE,Dhodhsar,Rural,3154,1907,1247,1773,625,1148
8,110,81,79366,0,0,RAJASTHAN,Jaipur,VILLAGE,Barhawali Dhani,Rural,588,360,228,345,110,235
8,110,81,79367,0,0,RAJASTHAN,Jaipur,VILLAGE,Nadiya,Rural,739,449,290,506,172,334
8,110,81,79368,0,0,RAJASTHAN,Jaipur,VILLAGE,Singod Khurd,Rural,2806,1728,1078,1708,617,1091
8,110,81,79369,0,0,RAJASTHAN,Jaipur,VILLAGE,Singod Kalan,Rural,3462,2091,1371,2169,783,1386
8,110,81,79370,0,0,RAJASTHAN,Jaipur,VILLAGE,Khejroli,Rural,9924,6094,3830,6607,2468,4139
8,110,81,79371,0,0,RAJASTHAN,Jaipur,VILLAGE,Utgadha,Rural,486,317,169,316,112,204
8,110,81,79372,0,0,RAJASTHAN,Jaipur,VILLAGE,Harad Rampura,Rural,1018,663,355,882,317,565
8,110,81,79373,0,0,RAJASTHAN,Jaipur,VILLAGE,Nindola,Rural,2017,1247,770,1364,489,875
8,110,81,79374,0,0,RAJASTHAN,Jaipur,VILLAGE,Chak Dalelpura,Rural,130,77,53,123,50,73
8,110,81,79375,0,0,RAJASTHAN,Jaipur,VILLAGE,Nangal Koju,Rural,2982,1927,1055,2298,861,1437
8,110,81,79376,0,0,RAJASTHAN,Jaipur,VILLAGE,Kanwarpura,Rural,1825,1173,652,1457,542,915
8,110,81,79377,0,0,RAJASTHAN,Jaipur,VILLAGE,Kumbhpuriya,Rural,519,327,192,347,109,238
8,110,81,79378,0,0,RAJASTHAN,Jaipur,VILLAGE,Chak Laddu,Rural,84,59,25,56,25,31
8,110,81,79379,0,0,RAJASTHAN,Jaipur,VILLAGE,Niwana,Rural,4347,2709,1638,2538,851,1687
8,110,81,79380,0,0,RAJASTHAN,Jaipur,VILLAGE,Devthala,Rural,2434,1476,958,1642,619,1023
8,110,81,79381,0,0,RAJASTHAN,Jaipur,VILLAGE,Badh Devthala,Rural,399,255,144,280,97,183
8,110,81,79382,0,0,RAJASTHAN,Jaipur,VILLAGE,Dhobolai,Rural,2408,1476,932,1826,691,1135
8,110,81,79383,0,0,RAJASTHAN,Jaipur,VILLAGE,Chak Charanwas,Rural,172,116,56,163,55,108
8,110,81,79384,0,0,RAJASTHAN,Jaipur,VILLAGE,Syaoo,Rural,796,494,302,619,231,388
8,110,81,79385,0,0,RAJASTHAN,Jaipur,VILLAGE,Kalu Ka Bas@ Shyam Nagar,Rural,1123,648,475,347,118,229
8,110,81,79386,0,0,RAJASTHAN,Jaipur,VILLAGE,Vikash Nagar,Rural,528,325,203,347,130,217
8,110,81,79387,0,0,RAJASTHAN,Jaipur,VILLAGE,Malikpur,Rural,3027,1896,1131,1811,641,1170
8,110,81,79388,0,0,RAJASTHAN,Jaipur,VILLAGE,Sitaram Pura,Rural,1086,680,406,756,260,496
8,110,81,79389,0,0,RAJASTHAN,Jaipur,VILLAGE,Charanwas,Rural,729,436,293,373,126,247
8,110,81,79390,0,0,RAJASTHAN,Jaipur,VILLAGE,Sandarsar,Rural,1896,1146,750,1292,474,818
8,110,81,79391,0,0,RAJASTHAN,Jaipur,VILLAGE,Kumbha Ka Bas,Rural,269,150,119,109,43,66
8,110,81,79392,0,0,RAJASTHAN,Jaipur,VILLAGE,Badh Abhayakaranpura,Rural,135,91,44,85,27,58
8,110,81,79393,0,0,RAJASTHAN,Jaipur,VILLAGE,Aleesar,Rural,2571,1568,1003,1699,647,1052
8,110,81,79394,0,0,RAJASTHAN,Jaipur,VILLAGE,Baga Ka Bas,Rural,566,356,210,313,110,203
8,110,81,79395,0,0,RAJASTHAN,Jaipur,VILLAGE,Damba Ka Bas,Rural,753,459,294,509,204,305
8,110,81,79396,0,0,RAJASTHAN,Jaipur,VILLAGE,Nopura,Rural,754,458,296,545,193,352
8,110,81,79397,0,0,RAJASTHAN,Jaipur,VILLAGE,Hasteda,Rural,2711,1651,1060,1778,653,1125
8,110,81,79398,0,0,RAJASTHAN,Jaipur,VILLAGE,Lalpura,Rural,535,336,199,407,161,246
8,110,81,79399,0,0,RAJASTHAN,Jaipur,VILLAGE,Vijay Nagar,Rural,607,387,220,505,210,295
8,110,81,79400,0,0,RAJASTHAN,Jaipur,VILLAGE,Bawari Gopinath,Rural,1009,614,395,753,285,468
8,110,81,79401,0,0,RAJASTHAN,Jaipur,VILLAGE,Gori Ka Bas,Rural,746,472,274,535,183,352
8,110,81,79402,0,0,RAJASTHAN,Jaipur,VILLAGE,Sabalpura,Rural,639,383,256,370,124,246
8,110,81,79403,0,0,RAJASTHAN,Jaipur,VILLAGE,Ghinoi,Rural,2469,1538,931,1659,616,1043
8,110,81,79404,0,0,RAJASTHAN,Jaipur,VILLAGE,Dhani Nijharna,Rural,46,27,19,33,11,22
8,110,81,79405,0,0,RAJASTHAN,Jaipur,VILLAGE,Dola Ka Bas,Rural,1036,638,398,710,256,454
8,110,81,79406,0,0,RAJASTHAN,Jaipur,VILLAGE,Bai Ka Bas,Rural,894,552,342,564,202,362
8,110,81,79407,0,0,RAJASTHAN,Jaipur,VILLAGE,Mandha Bhinda,Rural,1329,802,527,916,346,570
8,110,81,79408,0,0,RAJASTHAN,Jaipur,VILLAGE,Pragati Naya Bas,Rural,510,335,175,391,136,255
8,110,81,79409,0,0,RAJASTHAN,Jaipur,VILLAGE,Daulatpura,Rural,564,356,208,381,148,233
8,110,81,79410,0,0,RAJASTHAN,Jaipur,VILLAGE,Kanarpura,Rural,1089,655,434,694,265,429
8,110,81,79411,0,0,RAJASTHAN,Jaipur,VILLAGE,Vimalpura,Rural,1184,777,407,834,298,536
8,110,81,79412,0,0,RAJASTHAN,Jaipur,VILLAGE,Jalim Singh Ka Bas,Rural,616,396,220,365,123,242
8,110,81,79413,0,0,RAJASTHAN,Jaipur,VILLAGE,Dhana Ka Bas,Rural,267,169,98,190,64,126
8,110,81,79414,0,0,RAJASTHAN,Jaipur,VILLAGE,Kaladera,Rural,8606,5191,3415,4545,1691,2854
8,110,81,79415,0,0,RAJASTHAN,Jaipur,VILLAGE,Khanni Pura,Rural,952,586,366,635,231,404
8,110,81,79416,0,0,RAJASTHAN,Jaipur,VILLAGE,Narsinghpura,Rural,1138,760,378,895,335,560
8,110,81,79417,0,0,RAJASTHAN,Jaipur,VILLAGE,Ugariyawas,Rural,322,195,127,284,114,170
8,110,81,79418,0,0,RAJASTHAN,Jaipur,VILLAGE,Jaisinghpura Nathawatan,Rural,899,557,342,638,246,392
8,110,81,79419,0,0,RAJASTHAN,Jaipur,VILLAGE,Guwardi,Rural,1482,957,525,972,330,642
8,110,81,79420,0,0,RAJASTHAN,Jaipur,VILLAGE,Chak Tankarda,Rural,87,55,32,44,12,32
8,110,81,79421,0,0,RAJASTHAN,Jaipur,VILLAGE,Devpura,Rural,1177,735,442,796,336,460
8,110,81,79422,0,0,RAJASTHAN,Jaipur,VILLAGE,Dahara Tankarda,Rural,369,225,144,235,93,142
8,110,81,79423,0,0,RAJASTHAN,Jaipur,VILLAGE,Jodhpura,Rural,790,466,324,440,157,283
8,110,81,79424,0,0,RAJASTHAN,Jaipur,VILLAGE,Adagela,Rural,795,482,313,450,164,286
8,110,81,79425,0,0,RAJASTHAN,Jaipur,VILLAGE,Tankarda,Rural,1192,740,452,545,167,378
8,110,81,79426,0,0,RAJASTHAN,Jaipur,VILLAGE,Naya Bas,Rural,789,495,294,524,186,338
8,110,81,79427,0,0,RAJASTHAN,Jaipur,VILLAGE,Loharwara,Rural,2340,1480,860,1390,479,911
8,110,81,79428,0,0,RAJASTHAN,Jaipur,VILLAGE,Balekhan,Rural,1087,722,365,675,213,462
8,110,81,79429,0,0,RAJASTHAN,Jaipur,VILLAGE,Anatpura,Rural,1815,1083,732,1145,408,737
8,110,81,79430,0,0,RAJASTHAN,Jaipur,VILLAGE,Chimanpura,Rural,563,367,196,400,135,265
8,110,81,79431,0,0,RAJASTHAN,Jaipur,VILLAGE,Itawa Bhopji,Rural,6814,4185,2629,4067,1462,2605
8,110,81,79432,0,0,RAJASTHAN,Jaipur,VILLAGE,Bishanpura @ Charanwas,Rural,1874,1138,736,1153,412,741
8,110,81,79433,0,0,RAJASTHAN,Jaipur,VILLAGE,Amarpura,Rural,1967,1215,752,1286,474,812
8,110,81,79434,0,0,RAJASTHAN,Jaipur,VILLAGE,Kaloo Ka Bas,Rural,1321,815,506,1014,387,627
8,110,81,79435,0,0,RAJASTHAN,Jaipur,VILLAGE,Tigariya,Rural,5005,3163,1842,3541,1350,2191
8,110,81,79436,0,0,RAJASTHAN,Jaipur,VILLAGE,Barwara,Rural,1690,1045,645,1012,348,664
8,110,81,79437,0,0,RAJASTHAN,Jaipur,VILLAGE,Nangal Bharda,Rural,3782,2304,1478,2617,977,1640
8,110,81,79438,0,0,RAJASTHAN,Jaipur,VILLAGE,Udaipuriya,Rural,5703,3583,2120,3678,1323,2355
8,110,81,79439,0,0,RAJASTHAN,Jaipur,VILLAGE,Harota,Rural,4710,2952,1758,2751,987,1764
8,110,81,79440,0,0,RAJASTHAN,Jaipur,VILLAGE,Bhopawas,Rural,1931,1243,688,1475,537,938
8,110,81,79441,0,0,RAJASTHAN,Jaipur,VILLAGE,Hathnoda,Rural,3400,2105,1295,2194,786,1408
8,110,81,79442,0,0,RAJASTHAN,Jaipur,VILLAGE,Samod,Rural,6153,3734,2419,3212,1197,2015
8,110,81,79443,0,0,RAJASTHAN,Jaipur,VILLAGE,Mahar Kalan,Rural,2472,1525,947,1566,581,985
8,110,81,79444,0,0,RAJASTHAN,Jaipur,VILLAGE,Dehra,Rural,869,562,307,761,311,450
8,110,81,79445,0,0,RAJASTHAN,Jaipur,VILLAGE,Shimbhupura,Rural,458,277,181,354,135,219
8,110,81,79446,0,0,RAJASTHAN,Jaipur,VILLAGE,Kanpura,Rural,1312,847,465,1038,393,645
8,110,81,79447,0,0,RAJASTHAN,Jaipur,VILLAGE,Jatanwali,Rural,1344,842,502,765,257,508
8,110,81,79448,0,0,RAJASTHAN,Jaipur,VILLAGE,Vijaysinghpura,Rural,1414,919,495,1178,408,770
8,110,81,79449,0,0,RAJASTHAN,Jaipur,VILLAGE,Kushalpura,Rural,2411,1523,888,1421,476,945
8,110,81,79450,0,0,RAJASTHAN,Jaipur,VILLAGE,Morija,Rural,8272,5126,3146,5090,1886,3204
8,110,81,79451,0,0,RAJASTHAN,Jaipur,VILLAGE,Jaitpura,Rural,4030,2522,1508,2690,977,1713
8,110,81,79452,0,0,RAJASTHAN,Jaipur,VILLAGE,Anantpura,Rural,3666,2319,1347,2384,858,1526
8,110,81,79453,0,0,RAJASTHAN,Jaipur,VILLAGE,Cheethwari,Rural,3864,2427,1437,2497,928,1569
8,110,81,79454,0,0,RAJASTHAN,Jaipur,VILLAGE,Dhani Gogoriya,Rural,1045,663,382,729,270,459
8,110,81,79455,0,0,RAJASTHAN,Jaipur,VILLAGE,Fatehpura,Rural,2324,1442,882,1242,412,830
8,110,81,79456,0,0,RAJASTHAN,Jaipur,VILLAGE,Sultanpura,Rural,803,535,268,672,214,458
8,110,81,79457,0,0,RAJASTHAN,Jaipur,VILLAGE,Jheera,Rural,648,417,231,512,205,307
8,110,81,79458,0,0,RAJASTHAN,Jaipur,VILLAGE,Samarpura,Rural,1139,713,426,819,308,511
8,110,81,79459,0,0,RAJASTHAN,Jaipur,VILLAGE,Malera,Rural,453,286,167,309,122,187
8,110,81,79460,0,0,RAJASTHAN,Jaipur,TOWN,Govindgarh (CT),Urban,5307,3050,2257,2428,910,1518
8,110,82,0,0,0,RAJASTHAN,Jaipur,CD BLOCK,Dudu,Total,176312,112129,64183,151642,57520,94122
8,110,82,0,0,0,RAJASTHAN,Jaipur,CD BLOCK,Dudu,Rural,174053,110894,63159,151094,57330,93764
8,110,82,0,0,0,RAJASTHAN,Jaipur,CD BLOCK,Dudu,Urban,2259,1235,1024,548,190,358
8,110,82,79558,0,0,RAJASTHAN,Jaipur,VILLAGE,Gumanpura,Rural,628,397,231,492,173,319
8,110,82,79604,0,0,RAJASTHAN,Jaipur,VILLAGE,Dakaniyawas,Rural,157,92,65,120,49,71
8,110,82,79605,0,0,RAJASTHAN,Jaipur,VILLAGE,Chandpura,Rural,268,165,103,198,71,127
8,110,82,79606,0,0,RAJASTHAN,Jaipur,VILLAGE,Bamniyawas,Rural,375,233,142,340,138,202
8,110,82,79607,0,0,RAJASTHAN,Jaipur,VILLAGE,Budhji Ka Bas,Rural,31,17,14,12,6,6
8,110,82,79608,0,0,RAJASTHAN,Jaipur,VILLAGE,Dhani Chandpura,Rural,34,15,19,28,9,19
8,110,82,79609,0,0,RAJASTHAN,Jaipur,VILLAGE,Chak Budhji Ka Bas,Rural,47,37,10,39,12,27
8,110,82,79610,0,0,RAJASTHAN,Jaipur,VILLAGE,Bassi Jhajhra,Rural,477,299,178,301,95,206
8,110,82,79612,0,0,RAJASTHAN,Jaipur,VILLAGE,Kheri Aloopha,Rural,782,481,301,560,199,361
8,110,82,79613,0,0,RAJASTHAN,Jaipur,VILLAGE,Aidan Ka Bas,Rural,418,257,161,274,88,186
8,110,82,79614,0,0,RAJASTHAN,Jaipur,VILLAGE,Gurha Kumawatan,Rural,487,300,187,359,143,216
8,110,82,79615,0,0,RAJASTHAN,Jaipur,VILLAGE,Rampura,Rural,447,275,172,248,72,176
8,110,82,79616,0,0,RAJASTHAN,Jaipur,VILLAGE,Sardarpura @ Dhakawala,Rural,466,283,183,296,112,184
8,110,82,79617,0,0,RAJASTHAN,Jaipur,VILLAGE,Bobas,Rural,2605,1642,963,1977,729,1248
8,110,82,79618,0,0,RAJASTHAN,Jaipur,VILLAGE,Kanwarpura,Rural,154,93,61,56,13,43
8,110,82,79619,0,0,RAJASTHAN,Jaipur,VILLAGE,Asalpur,Rural,4834,2925,1909,2732,990,1742
8,110,82,79620,0,0,RAJASTHAN,Jaipur,VILLAGE,Badhmathuradas,Rural,81,48,33,37,12,25
8,110,82,79621,0,0,RAJASTHAN,Jaipur,VILLAGE,Dhani Boraj,Rural,2207,1387,820,1295,474,821
8,110,82,79622,0,0,RAJASTHAN,Jaipur,VILLAGE,Bhagwatpura,Rural,1044,643,401,810,295,515
8,110,82,79623,0,0,RAJASTHAN,Jaipur,VILLAGE,Bhasinghpura,Rural,710,472,238,531,200,331
8,110,82,79624,0,0,RAJASTHAN,Jaipur,VILLAGE,Majipura,Rural,326,223,103,259,87,172
8,110,82,79625,0,0,RAJASTHAN,Jaipur,VILLAGE,Sursinghpura,Rural,716,468,248,521,182,339
8,110,82,79626,0,0,RAJASTHAN,Jaipur,VILLAGE,Malyawas,Rural,862,506,356,462,187,275
8,110,82,79633,0,0,RAJASTHAN,Jaipur,VILLAGE,Kanchroda,Rural,2096,1266,830,1014,353,661
8,110,82,79634,0,0,RAJASTHAN,Jaipur,VILLAGE,Dayal Nagar,Rural,1167,722,445,539,194,345
8,110,82,79635,0,0,RAJASTHAN,Jaipur,VILLAGE,Shyam Nagar,Rural,798,473,325,438,165,273
8,110,82,79636,0,0,RAJASTHAN,Jaipur,VILLAGE,Samalpura,Rural,963,621,342,781,267,514
8,110,82,79637,0,0,RAJASTHAN,Jaipur,VILLAGE,Haripura,Rural,552,344,208,354,114,240
8,110,82,79638,0,0,RAJASTHAN,Jaipur,VILLAGE,Baghpura,Rural,138,97,41,200,75,125
8,110,82,79639,0,0,RAJASTHAN,Jaipur,VILLAGE,Matera,Rural,431,294,137,598,239,359
8,110,82,79640,0,0,RAJASTHAN,Jaipur,VILLAGE,Mandpi,Rural,327,209,118,323,133,190
8,110,82,79641,0,0,RAJASTHAN,Jaipur,VILLAGE,Shri Rampura,Rural,642,427,215,647,250,397
8,110,82,79642,0,0,RAJASTHAN,Jaipur,VILLAGE,Morooda,Rural,536,349,187,479,208,271
8,110,82,79643,0,0,RAJASTHAN,Jaipur,VILLAGE,Midkya,Rural,214,140,74,173,79,94
8,110,82,79644,0,0,RAJASTHAN,Jaipur,VILLAGE,Panwa,Rural,3,1,2,2,2,0
8,110,82,79645,0,0,RAJASTHAN,Jaipur,VILLAGE,Shyami Ki Dhani,Rural,540,330,210,454,162,292
8,110,82,79646,0,0,RAJASTHAN,Jaipur,VILLAGE,Nagorpura,Rural,444,265,179,464,199,265
8,110,82,79647,0,0,RAJASTHAN,Jaipur,VILLAGE,Lalpura,Rural,540,322,218,360,127,233
8,110,82,79648,0,0,RAJASTHAN,Jaipur,VILLAGE,Kochya Ki Dhani,Rural,210,156,54,349,136,213
8,110,82,79649,0,0,RAJASTHAN,Jaipur,VILLAGE,Jhapok,Rural,262,176,86,222,64,158
8,110,82,79650,0,0,RAJASTHAN,Jaipur,VILLAGE,Gopalpura,Rural,684,469,215,689,243,446
8,110,82,79651,0,0,RAJASTHAN,Jaipur,VILLAGE,Habaspura,Rural,640,432,208,782,306,476
8,110,82,79652,0,0,RAJASTHAN,Jaipur,VILLAGE,Bhirawata,Rural,289,216,73,500,208,292
8,110,82,79653,0,0,RAJASTHAN,Jaipur,VILLAGE,Ringi,Rural,377,271,106,464,161,303
8,110,82,79654,0,0,RAJASTHAN,Jaipur,VILLAGE,Korseena,Rural,660,459,201,1270,532,738
8,110,82,79655,0,0,RAJASTHAN,Jaipur,VILLAGE,Dodwara,Rural,149,104,45,153,47,106
8,110,82,79656,0,0,RAJASTHAN,Jaipur,VILLAGE,Sarthala,Rural,215,170,45,543,248,295
8,110,82,79657,0,0,RAJASTHAN,Jaipur,VILLAGE,Chhapri,Rural,208,152,56,447,192,255
8,110,82,79658,0,0,RAJASTHAN,Jaipur,VILLAGE,Govindpura,Rural,183,130,53,208,77,131
8,110,82,79659,0,0,RAJASTHAN,Jaipur,VILLAGE,Jawli,Rural,301,217,84,537,223,314
8,110,82,79660,0,0,RAJASTHAN,Jaipur,VILLAGE,Sitarampura,Rural,219,152,67,254,94,160
8,110,82,79661,0,0,RAJASTHAN,Jaipur,VILLAGE,Mordi Khurd,Rural,257,162,95,271,113,158
8,110,82,79662,0,0,RAJASTHAN,Jaipur,VILLAGE,Shekhpura,Rural,3,2,1,2,0,2
8,110,82,79663,0,0,RAJASTHAN,Jaipur,VILLAGE,Nangal,Rural,232,155,77,346,139,207
8,110,82,79664,0,0,RAJASTHAN,Jaipur,VILLAGE,Kalyan,Rural,211,141,70,367,163,204
8,110,82,79665,0,0,RAJASTHAN,Jaipur,VILLAGE,Dobri,Rural,267,206,61,546,230,316
8,110,82,79666,0,0,RAJASTHAN,Jaipur,VILLAGE,Singla,Rural,141,100,41,236,93,143
8,110,82,79667,0,0,RAJASTHAN,Jaipur,VILLAGE,Hachookra,Rural,477,298,179,581,246,335
8,110,82,79668,0,0,RAJASTHAN,Jaipur,VILLAGE,Sholawata,Rural,527,338,189,564,239,325
8,110,82,79669,0,0,RAJASTHAN,Jaipur,VILLAGE,Sirohi Khurd,Rural,269,199,70,431,176,255
8,110,82,79670,0,0,RAJASTHAN,Jaipur,VILLAGE,Kothera,Rural,102,67,35,50,14,36
8,110,82,79671,0,0,RAJASTHAN,Jaipur,VILLAGE,Narayana,Rural,7568,4749,2819,5707,2128,3579
8,110,82,79672,0,0,RAJASTHAN,Jaipur,VILLAGE,Bhartolao,Rural,1231,805,426,1357,534,823
8,110,82,79673,0,0,RAJASTHAN,Jaipur,VILLAGE,Naradpura,Rural,126,87,39,241,116,125
8,110,82,79674,0,0,RAJASTHAN,Jaipur,VILLAGE,Peethyawas,Rural,483,327,156,498,191,307
8,110,82,79675,0,0,RAJASTHAN,Jaipur,VILLAGE,Chainpura,Rural,588,385,203,639,247,392
8,110,82,79676,0,0,RAJASTHAN,Jaipur,VILLAGE,Morsar,Rural,272,187,85,301,116,185
8,110,82,79677,0,0,RAJASTHAN,Jaipur,VILLAGE,Charanwas,Rural,98,68,30,102,39,63
8,110,82,79678,0,0,RAJASTHAN,Jaipur,VILLAGE,Ramnagar,Rural,125,72,53,70,24,46
8,110,82,79679,0,0,RAJASTHAN,Jaipur,VILLAGE,Bhawasa,Rural,216,133,83,172,68,104
8,110,82,79680,0,0,RAJASTHAN,Jaipur,VILLAGE,Kandeoli,Rural,412,256,156,180,61,119
8,110,82,79681,0,0,RAJASTHAN,Jaipur,VILLAGE,Shardulpura,Rural,971,611,360,543,189,354
8,110,82,79682,0,0,RAJASTHAN,Jaipur,VILLAGE,Shyosinghpura,Rural,904,565,339,677,261,416
8,110,82,79683,0,0,RAJASTHAN,Jaipur,VILLAGE,Akoda,Rural,1791,1100,691,1119,418,701
8,110,82,79684,0,0,RAJASTHAN,Jaipur,VILLAGE,Kudiyon Ki Dhani,Rural,500,334,166,486,199,287
8,110,82,79685,0,0,RAJASTHAN,Jaipur,VILLAGE,Palbas,Rural,196,128,68,303,136,167
8,110,82,79686,0,0,RAJASTHAN,Jaipur,VILLAGE,Ramsagar,Rural,397,290,107,401,145,256
8,110,82,79687,0,0,RAJASTHAN,Jaipur,VILLAGE,Sainipura,Rural,357,222,135,269,109,160
8,110,82,79688,0,0,RAJASTHAN,Jaipur,VILLAGE,Kheriram,Rural,953,585,368,585,207,378
8,110,82,79689,0,0,RAJASTHAN,Jaipur,VILLAGE,Mannapura,Rural,685,404,281,422,152,270
8,110,82,79690,0,0,RAJASTHAN,Jaipur,VILLAGE,Samota Ka Bas,Rural,902,570,332,621,198,423
8,110,82,79691,0,0,RAJASTHAN,Jaipur,VILLAGE,Rojri,Rural,2727,1699,1028,1729,636,1093
8,110,82,79692,0,0,RAJASTHAN,Jaipur,VILLAGE,Hirnoda,Rural,3937,2368,1569,2292,818,1474
8,110,82,79693,0,0,RAJASTHAN,Jaipur,VILLAGE,Dhinda,Rural,1245,757,488,656,245,411
8,110,82,79694,0,0,RAJASTHAN,Jaipur,VILLAGE,Kanderiyan Ki Dhani,Rural,435,268,167,214,71,143
8,110,82,79695,0,0,RAJASTHAN,Jaipur,VILLAGE,Chandsinghpura,Rural,401,228,173,259,92,167
8,110,82,79696,0,0,RAJASTHAN,Jaipur,VILLAGE,Maheshwas,Rural,952,604,348,801,302,499
8,110,82,79699,0,0,RAJASTHAN,Jaipur,VILLAGE,Sirohi Kalan,Rural,621,414,207,627,226,401
8,110,82,79700,0,0,RAJASTHAN,Jaipur,VILLAGE,Gahlota,Rural,1122,693,429,944,341,603
8,110,82,79701,0,0,RAJASTHAN,Jaipur,VILLAGE,Chhirr,Rural,440,287,153,391,137,254
8,110,82,79702,0,0,RAJASTHAN,Jaipur,VILLAGE,Sali,Rural,1650,1072,578,1607,622,985
8,110,82,79703,0,0,RAJASTHAN,Jaipur,VILLAGE,Surree,Rural,308,185,123,203,62,141
8,110,82,79704,0,0,RAJASTHAN,Jaipur,VILLAGE,Panva Kalan,Rural,381,279,102,613,244,369
8,110,82,79705,0,0,RAJASTHAN,Jaipur,VILLAGE,Marwa,Rural,1252,783,469,1079,395,684
8,110,82,79706,0,0,RAJASTHAN,Jaipur,VILLAGE,Adarwa,Rural,531,356,175,558,210,348
8,110,82,79707,0,0,RAJASTHAN,Jaipur,VILLAGE,Morda,Rural,647,432,215,730,270,460
8,110,82,79708,0,0,RAJASTHAN,Jaipur,VILLAGE,Mordi Kalan,Rural,100,57,43,84,41,43
8,110,82,79709,0,0,RAJASTHAN,Jaipur,VILLAGE,Mamana,Rural,1071,725,346,1317,533,784
8,110,82,79710,0,0,RAJASTHAN,Jaipur,VILLAGE,Kheda Nagran,Rural,168,115,53,315,128,187
8,110,82,79711,0,0,RAJASTHAN,Jaipur,VILLAGE,Neemli,Rural,607,385,222,603,216,387
8,110,82,79712,0,0,RAJASTHAN,Jaipur,VILLAGE,Dantra,Rural,348,228,120,302,106,196
8,110,82,79713,0,0,RAJASTHAN,Jaipur,VILLAGE,Jhakolar,Rural,191,145,46,257,93,164
8,110,82,79714,0,0,RAJASTHAN,Jaipur,VILLAGE,Panwaliya,Rural,263,175,88,304,89,215
8,110,82,79715,0,0,RAJASTHAN,Jaipur,VILLAGE,Beegolao,Rural,366,234,132,390,153,237
8,110,82,79716,0,0,RAJASTHAN,Jaipur,VILLAGE,Bokarawas,Rural,303,198,105,326,124,202
8,110,82,79717,0,0,RAJASTHAN,Jaipur,VILLAGE,Jarawata,Rural,403,273,130,656,282,374
8,110,82,79718,0,0,RAJASTHAN,Jaipur,VILLAGE,Peegoon,Rural,426,308,118,450,162,288
8,110,82,79719,0,0,RAJASTHAN,Jaipur,VILLAGE,Khajpura,Rural,148,100,48,169,64,105
8,110,82,79720,0,0,RAJASTHAN,Jaipur,VILLAGE,Deopura,Rural,377,262,115,696,284,412
8,110,82,79721,0,0,RAJASTHAN,Jaipur,VILLAGE,Hatoopura,Rural,1002,674,328,1257,502,755
8,110,82,79722,0,0,RAJASTHAN,Jaipur,VILLAGE,Sakhoon,Rural,3242,2090,1152,2712,1024,1688
8,110,82,79723,0,0,RAJASTHAN,Jaipur,VILLAGE,Shyopura,Rural,257,171,86,337,140,197
8,110,82,79724,0,0,RAJASTHAN,Jaipur,VILLAGE,Jassupura,Rural,417,287,130,462,175,287
8,110,82,79725,0,0,RAJASTHAN,Jaipur,VILLAGE,Nayagaon,Rural,496,352,144,595,229,366
8,110,82,79726,0,0,RAJASTHAN,Jaipur,VILLAGE,Ladera,Rural,717,480,237,975,387,588
8,110,82,79727,0,0,RAJASTHAN,Jaipur,VILLAGE,Patoori,Rural,233,174,59,311,121,190
8,110,82,79728,0,0,RAJASTHAN,Jaipur,VILLAGE,Dantri,Rural,587,396,191,714,277,437
8,110,82,79729,0,0,RAJASTHAN,Jaipur,VILLAGE,Kila,Rural,241,157,84,409,202,207
8,110,82,79730,0,0,RAJASTHAN,Jaipur,VILLAGE,Madhopura,Rural,331,205,126,308,118,190
8,110,82,79731,0,0,RAJASTHAN,Jaipur,VILLAGE,Mahatgaon,Rural,298,193,105,429,170,259
8,110,82,79732,0,0,RAJASTHAN,Jaipur,VILLAGE,Benee Khera,Rural,159,120,39,344,165,179
8,110,82,79733,0,0,RAJASTHAN,Jaipur,VILLAGE,Rahlana,Rural,1741,1176,565,2459,1040,1419
8,110,82,79734,0,0,RAJASTHAN,Jaipur,VILLAGE,Kairiya Bajurg,Rural,410,271,139,492,202,290
8,110,82,79735,0,0,RAJASTHAN,Jaipur,VILLAGE,Gaiga,Rural,121,79,42,88,31,57
8,110,82,79736,0,0,RAJASTHAN,Jaipur,VILLAGE,Parasoli,Rural,1722,1083,639,1578,625,953
8,110,82,79737,0,0,RAJASTHAN,Jaipur,VILLAGE,Gainji,Rural,842,558,284,1072,413,659
8,110,82,79738,0,0,RAJASTHAN,Jaipur,VILLAGE,Udaipuriya,Rural,739,488,251,568,227,341
8,110,82,79739,0,0,RAJASTHAN,Jaipur,VILLAGE,Nanan,Rural,414,262,152,327,106,221
8,110,82,79740,0,0,RAJASTHAN,Jaipur,VILLAGE,Jekampura,Rural,300,202,98,295,103,192
8,110,82,79741,0,0,RAJASTHAN,Jaipur,VILLAGE,Malera,Rural,605,405,200,726,291,435
8,110,82,79742,0,0,RAJASTHAN,Jaipur,VILLAGE,Kachnar,Rural,445,297,148,369,135,234
8,110,82,79743,0,0,RAJASTHAN,Jaipur,VILLAGE,Sawarda,Rural,2660,1710,950,2261,818,1443
8,110,82,79744,0,0,RAJASTHAN,Jaipur,VILLAGE,Beejolao,Rural,657,417,240,636,233,403
8,110,82,79745,0,0,RAJASTHAN,Jaipur,VILLAGE,Dudu,Rural,9274,5459,3815,5687,2241,3446
8,110,82,79746,0,0,RAJASTHAN,Jaipur,VILLAGE,Mal Ki Dhani,Rural,275,183,92,580,254,326
8,110,82,79747,0,0,RAJASTHAN,Jaipur,VILLAGE,Nolya,Rural,203,138,65,375,162,213
8,110,82,79748,0,0,RAJASTHAN,Jaipur,VILLAGE,Bhojpur,Rural,351,236,115,422,172,250
8,110,82,79749,0,0,RAJASTHAN,Jaipur,VILLAGE,Shri Ramnagar,Rural,330,215,115,261,95,166
8,110,82,79750,0,0,RAJASTHAN,Jaipur,VILLAGE,Gopipura,Rural,176,112,64,290,119,171
8,110,82,79751,0,0,RAJASTHAN,Jaipur,VILLAGE,Charasada,Rural,350,231,119,452,195,257
8,110,82,79752,0,0,RAJASTHAN,Jaipur,VILLAGE,Chhapya,Rural,523,326,197,742,305,437
8,110,82,79753,0,0,RAJASTHAN,Jaipur,VILLAGE,Harsauli,Rural,1943,1274,669,1781,642,1139
8,110,82,79754,0,0,RAJASTHAN,Jaipur,VILLAGE,Gagardoo,Rural,1443,910,533,1116,445,671
8,110,82,79755,0,0,RAJASTHAN,Jaipur,VILLAGE,Laporiya,Rural,778,535,243,986,367,619
8,110,82,79756,0,0,RAJASTHAN,Jaipur,VILLAGE,Sanaudiya,Rural,399,268,131,483,184,299
8,110,82,79757,0,0,RAJASTHAN,Jaipur,VILLAGE,Dhandhonli,Rural,1234,894,340,1780,743,1037
8,110,82,79758,0,0,RAJASTHAN,Jaipur,VILLAGE,Itakhoi,Rural,470,318,152,946,400,546
8,110,82,79759,0,0,RAJASTHAN,Jaipur,VILLAGE,Gothra,Rural,0,0,0,0,0,0
8,110,82,79760,0,0,RAJASTHAN,Jaipur,VILLAGE,Nagri,Rural,210,135,75,222,83,139
8,110,82,79761,0,0,RAJASTHAN,Jaipur,VILLAGE,Kachnariya,Rural,687,456,231,943,386,557
8,110,82,79762,0,0,RAJASTHAN,Jaipur,VILLAGE,Kairiya Khurd,Rural,152,97,55,191,72,119
8,110,82,79763,0,0,RAJASTHAN,Jaipur,VILLAGE,Ursewa,Rural,697,468,229,738,273,465
8,110,82,79764,0,0,RAJASTHAN,Jaipur,VILLAGE,Kheri Charnan,Rural,123,80,43,111,41,70
8,110,82,79765,0,0,RAJASTHAN,Jaipur,VILLAGE,Norangpura,Rural,185,127,58,221,77,144
8,110,82,79766,0,0,RAJASTHAN,Jaipur,VILLAGE,Balapura,Rural,136,90,46,225,96,129
8,110,82,79767,0,0,RAJASTHAN,Jaipur,VILLAGE,Sunadiya,Rural,952,638,314,1046,385,661
8,110,82,79768,0,0,RAJASTHAN,Jaipur,VILLAGE,Tan Chhaparwara,Rural,0,0,0,0,0,0
8,110,82,79769,0,0,RAJASTHAN,Jaipur,VILLAGE,Chhaparwara,Rural,808,510,298,651,246,405
8,110,82,79770,0,0,RAJASTHAN,Jaipur,VILLAGE,Khuriyal,Rural,979,665,314,1202,459,743
8,110,82,79771,0,0,RAJASTHAN,Jaipur,VILLAGE,Baget,Rural,394,285,109,522,194,328
8,110,82,79772,0,0,RAJASTHAN,Jaipur,VILLAGE,Gidani,Rural,715,452,263,791,332,459
8,110,82,79773,0,0,RAJASTHAN,Jaipur,VILLAGE,Chak Maheshpura,Rural,0,0,0,0,0,0
8,110,82,79774,0,0,RAJASTHAN,Jaipur,VILLAGE,Paloo Khurd,Rural,375,239,136,291,105,186
8,110,82,79775,0,0,RAJASTHAN,Jaipur,VILLAGE,Paloo Kalan,Rural,848,566,282,678,225,453
8,110,82,79776,0,0,RAJASTHAN,Jaipur,VILLAGE,Mokhampura,Rural,971,606,365,707,261,446
8,110,82,79777,0,0,RAJASTHAN,Jaipur,VILLAGE,Keriya,Rural,404,255,149,433,170,263
8,110,82,79778,0,0,RAJASTHAN,Jaipur,VILLAGE,Bichoon,Rural,3544,2117,1427,2039,780,1259
8,110,82,79779,0,0,RAJASTHAN,Jaipur,VILLAGE,Jewlya Ka Bas,Rural,248,185,63,191,62,129
8,110,82,79780,0,0,RAJASTHAN,Jaipur,VILLAGE,Basra,Rural,399,233,166,292,112,180
8,110,82,79781,0,0,RAJASTHAN,Jaipur,VILLAGE,Sortho Ka Bas,Rural,277,221,56,339,112,227
8,110,82,79782,0,0,RAJASTHAN,Jaipur,VILLAGE,Bhairana,Rural,80,47,33,62,25,37
8,110,82,79783,0,0,RAJASTHAN,Jaipur,VILLAGE,Naya Bas,Rural,450,293,157,488,180,308
8,110,82,79784,0,0,RAJASTHAN,Jaipur,VILLAGE,Gopalpura,Rural,655,428,227,452,151,301
8,110,82,79785,0,0,RAJASTHAN,Jaipur,VILLAGE,Ugariyawas,Rural,2254,1397,857,1360,465,895
8,110,82,79786,0,0,RAJASTHAN,Jaipur,VILLAGE,Rampura @ Bariyan,Rural,1066,661,405,568,194,374
8,110,82,79787,0,0,RAJASTHAN,Jaipur,VILLAGE,Gurha Bairsal,Rural,2427,1505,922,1409,510,899
8,110,82,79788,0,0,RAJASTHAN,Jaipur,VILLAGE,Soorpura,Rural,891,558,333,677,246,431
8,110,82,79789,0,0,RAJASTHAN,Jaipur,VILLAGE,Chandrabhanpura,Rural,457,283,174,299,112,187
8,110,82,79790,0,0,RAJASTHAN,Jaipur,VILLAGE,Boraj,Rural,5528,3362,2166,3251,1152,2099
8,110,82,79791,0,0,RAJASTHAN,Jaipur,VILLAGE,Dewala,Rural,1206,742,464,790,268,522
8,110,82,79792,0,0,RAJASTHAN,Jaipur,VILLAGE,Kesrisingh Pura,Rural,675,447,228,407,130,277
8,110,82,79793,0,0,RAJASTHAN,Jaipur,VILLAGE,Chan Chukaya,Rural,539,309,230,312,131,181
8,110,82,79794,0,0,RAJASTHAN,Jaipur,VILLAGE,Mahlan,Rural,2780,1726,1054,1717,623,1094
8,110,82,79795,0,0,RAJASTHAN,Jaipur,VILLAGE,Kalyansar,Rural,149,102,47,158,54,104
8,110,82,79796,0,0,RAJASTHAN,Jaipur,VILLAGE,Girdharipura,Rural,299,193,106,197,70,127
8,110,82,79797,0,0,RAJASTHAN,Jaipur,VILLAGE,Nasnota,Rural,799,510,289,657,215,442
8,110,82,79798,0,0,RAJASTHAN,Jaipur,VILLAGE,Jharna,Rural,907,496,411,640,237,403
8,110,82,79799,0,0,RAJASTHAN,Jaipur,VILLAGE,Kot Jewar,Rural,503,314,189,373,122,251
8,110,82,79800,0,0,RAJASTHAN,Jaipur,VILLAGE,Kapriyawas Khurd,Rural,310,203,107,176,47,129
8,110,82,79801,0,0,RAJASTHAN,Jaipur,VILLAGE,Kapriyawas Kalan,Rural,652,402,250,412,138,274
8,110,82,79802,0,0,RAJASTHAN,Jaipur,VILLAGE,Shyosingpura Basri,Rural,137,73,64,56,18,38
8,110,82,79803,0,0,RAJASTHAN,Jaipur,VILLAGE,Chak Nasnota,Rural,0,0,0,0,0,0
8,110,82,79804,0,0,RAJASTHAN,Jaipur,VILLAGE,Garoti,Rural,232,150,82,144,42,102
8,110,82,79805,0,0,RAJASTHAN,Jaipur,VILLAGE,Sitarampura,Rural,267,164,103,183,59,124
8,110,82,79806,0,0,RAJASTHAN,Jaipur,VILLAGE,Gadota,Rural,493,315,178,324,102,222
8,110,82,79807,0,0,RAJASTHAN,Jaipur,VILLAGE,Karwo Ka Bas,Rural,841,532,309,454,143,311
8,110,82,79808,0,0,RAJASTHAN,Jaipur,VILLAGE,Khatwar,Rural,721,477,244,737,287,450
8,110,82,79809,0,0,RAJASTHAN,Jaipur,VILLAGE,Gangati Kalan,Rural,691,450,241,505,144,361
8,110,82,79810,0,0,RAJASTHAN,Jaipur,VILLAGE,Anantpura,Rural,271,179,92,230,82,148
8,110,82,79811,0,0,RAJASTHAN,Jaipur,VILLAGE,Akhepura,Rural,704,455,249,784,291,493
8,110,82,79812,0,0,RAJASTHAN,Jaipur,VILLAGE,Manpura,Rural,270,176,94,282,108,174
8,110,82,79813,0,0,RAJASTHAN,Jaipur,VILLAGE,Maheshpura,Rural,243,163,80,297,114,183
8,110,82,79814,0,0,RAJASTHAN,Jaipur,VILLAGE,Chandarmool,Rural,179,114,65,212,73,139
8,110,82,79815,0,0,RAJASTHAN,Jaipur,VILLAGE,Gurha Saipura,Rural,506,359,147,585,220,365
8,110,82,79816,0,0,RAJASTHAN,Jaipur,VILLAGE,Shyosinghpura @ Basra,Rural,210,142,68,230,81,149
8,110,82,79817,0,0,RAJASTHAN,Jaipur,VILLAGE,Mauzamabad,Rural,4424,2850,1574,4211,1613,2598
8,110,82,79818,0,0,RAJASTHAN,Jaipur,VILLAGE,Tumbej Pura,Rural,291,210,81,423,166,257
8,110,82,79819,0,0,RAJASTHAN,Jaipur,VILLAGE,Kakrala,Rural,152,98,54,194,84,110
8,110,82,79820,0,0,RAJASTHAN,Jaipur,VILLAGE,Barh Kakrala,Rural,0,0,0,0,0,0
8,110,82,79821,0,0,RAJASTHAN,Jaipur,VILLAGE,Ganeshpura,Rural,306,202,104,382,145,237
8,110,82,79822,0,0,RAJASTHAN,Jaipur,VILLAGE,Mangalwara,Rural,938,599,339,880,353,527
8,110,82,79823,0,0,RAJASTHAN,Jaipur,VILLAGE,Dhani Nanda,Rural,109,83,26,534,255,279
8,110,82,79824,0,0,RAJASTHAN,Jaipur,VILLAGE,Moongi Thala,Rural,298,183,115,275,94,181
8,110,82,79825,0,0,RAJASTHAN,Jaipur,VILLAGE,Sewa,Rural,1453,918,535,1165,413,752
8,110,82,79826,0,0,RAJASTHAN,Jaipur,VILLAGE,Nachanipura,Rural,124,85,39,250,106,144
8,110,82,79827,0,0,RAJASTHAN,Jaipur,VILLAGE,Dayalpura,Rural,213,134,79,216,78,138
8,110,82,79828,0,0,RAJASTHAN,Jaipur,VILLAGE,Kalyanpura,Rural,400,273,127,494,183,311
8,110,82,79829,0,0,RAJASTHAN,Jaipur,VILLAGE,Roshanpura @ Baneriya,Rural,241,160,81,189,65,124
8,110,82,79830,0,0,RAJASTHAN,Jaipur,VILLAGE,Raseeli,Rural,555,380,175,519,185,334
8,110,82,79831,0,0,RAJASTHAN,Jaipur,VILLAGE,Reta,Rural,458,296,162,401,146,255
8,110,82,79832,0,0,RAJASTHAN,Jaipur,VILLAGE,Reti,Rural,290,186,104,369,139,230
8,110,82,79833,0,0,RAJASTHAN,Jaipur,VILLAGE,Fariyadpura,Rural,374,255,119,423,146,277
8,110,82,79834,0,0,RAJASTHAN,Jaipur,VILLAGE,Shrirampura,Rural,218,152,66,251,102,149
8,110,82,79835,0,0,RAJASTHAN,Jaipur,VILLAGE,Dogra,Rural,258,164,94,237,98,139
8,110,82,79836,0,0,RAJASTHAN,Jaipur,VILLAGE,Kheri Suwa,Rural,372,265,107,526,223,303
8,110,82,79837,0,0,RAJASTHAN,Jaipur,VILLAGE,Meerapura,Rural,487,337,150,679,268,411
8,110,82,79838,0,0,RAJASTHAN,Jaipur,VILLAGE,Dogri,Rural,167,115,52,172,67,105
8,110,82,79839,0,0,RAJASTHAN,Jaipur,VILLAGE,Lordi,Rural,935,614,321,929,332,597
8,110,82,79840,0,0,RAJASTHAN,Jaipur,VILLAGE,Sawai Mansinghpura,Rural,218,144,74,167,68,99
8,110,82,79841,0,0,RAJASTHAN,Jaipur,VILLAGE,Sawai Madhosinghpura,Rural,527,326,201,347,125,222
8,110,82,79842,0,0,RAJASTHAN,Jaipur,VILLAGE,Chak Meerapura,Rural,0,0,0,0,0,0
8,110,82,79843,0,0,RAJASTHAN,Jaipur,VILLAGE,Dhamana,Rural,840,562,278,1035,394,641
8,110,82,79844,0,0,RAJASTHAN,Jaipur,VILLAGE,Biharipura,Rural,1070,715,355,1270,503,767
8,110,82,79845,0,0,RAJASTHAN,Jaipur,VILLAGE,Sanwali,Rural,1023,659,364,1072,424,648
8,110,82,79846,0,0,RAJASTHAN,Jaipur,VILLAGE,Dedoo,Rural,308,194,114,332,130,202
8,110,82,79847,0,0,RAJASTHAN,Jaipur,VILLAGE,Rampura Bhoortiya,Rural,472,294,178,824,384,440
8,110,82,79848,0,0,RAJASTHAN,Jaipur,VILLAGE,Chak Jhag,Rural,0,0,0,0,0,0
8,110,82,79849,0,0,RAJASTHAN,Jaipur,VILLAGE,Kishanpura,Rural,745,479,266,813,319,494
8,110,82,79850,0,0,RAJASTHAN,Jaipur,VILLAGE,Chak Dudu,Rural,0,0,0,0,0,0
8,110,82,79851,0,0,RAJASTHAN,Jaipur,VILLAGE,Gangati Khurd,Rural,407,255,152,380,138,242
8,110,82,79852,0,0,RAJASTHAN,Jaipur,VILLAGE,Tan Jhag,Rural,0,0,0,0,0,0
8,110,82,79853,0,0,RAJASTHAN,Jaipur,VILLAGE,Shriniwaspura,Rural,233,152,81,150,45,105
8,110,82,79854,0,0,RAJASTHAN,Jaipur,VILLAGE,Jhag,Rural,2465,1543,922,2127,803,1324
8,110,82,79855,0,0,RAJASTHAN,Jaipur,VILLAGE,Bhagwatsinghpura,Rural,176,116,60,122,42,80
8,110,82,800519,21,0,RAJASTHAN,Jaipur,OG,Dayal Nagar (OG) (Part) WARD NO.-0021 (Rural MDDS CODE:079634),Urban,678,375,303,132,51,81
8,110,82,800519,22,0,RAJASTHAN,Jaipur,OG,Shyam Nagar (OG) (Part) WARD NO.-0022 (Rural MDDS CODE:079635),Urban,1581,860,721,416,139,277
8,110,83,0,0,0,RAJASTHAN,Jaipur,CD BLOCK,Sambhar,Total,145589,90537,55052,97412,35286,62126
8,110,83,0,0,0,RAJASTHAN,Jaipur,CD BLOCK,Sambhar,Rural,145589,90537,55052,97412,35286,62126
8,110,83,0,0,0,RAJASTHAN,Jaipur,CD BLOCK,Sambhar,Urban,0,0,0,0,0,0
8,110,83,79461,0,0,RAJASTHAN,Jaipur,VILLAGE,Kishanpura @ Nathi Ka Bas,Rural,1286,820,466,827,274,553
8,110,83,79462,0,0,RAJASTHAN,Jaipur,VILLAGE,Sanwat Ka Bas,Rural,379,253,126,256,86,170
8,110,83,79463,0,0,RAJASTHAN,Jaipur,VILLAGE,Basri Khurd,Rural,1467,879,588,761,259,502
8,110,83,79464,0,0,RAJASTHAN,Jaipur,VILLAGE,Ralawata,Rural,1230,796,434,724,247,477
8,110,83,79465,0,0,RAJASTHAN,Jaipur,VILLAGE,Malikpura,Rural,1886,1195,691,1188,416,772
8,110,83,79466,0,0,RAJASTHAN,Jaipur,VILLAGE,Rampura,Rural,615,374,241,448,153,295
8,110,83,79467,0,0,RAJASTHAN,Jaipur,VILLAGE,Surpura,Rural,355,222,133,183,60,123
8,110,83,79468,0,0,RAJASTHAN,Jaipur,VILLAGE,Bajiyon Ka Bas,Rural,450,288,162,178,53,125
8,110,83,79469,0,0,RAJASTHAN,Jaipur,VILLAGE,Charanwas,Rural,92,48,44,42,13,29
8,110,83,79470,0,0,RAJASTHAN,Jaipur,VILLAGE,Turkyawas,Rural,912,572,340,629,234,395
8,110,83,79471,0,0,RAJASTHAN,Jaipur,VILLAGE,Looniyawas,Rural,1823,1087,736,1230,429,801
8,110,83,79472,0,0,RAJASTHAN,Jaipur,VILLAGE,Gadri,Rural,1131,687,444,743,266,477
8,110,83,79473,0,0,RAJASTHAN,Jaipur,VILLAGE,Badhal,Rural,5972,3685,2287,3510,1261,2249
8,110,83,79474,0,0,RAJASTHAN,Jaipur,VILLAGE,Kabron Ka Bas,Rural,1199,743,456,645,206,439
8,110,83,79475,0,0,RAJASTHAN,Jaipur,VILLAGE,Itawa,Rural,2714,1694,1020,1585,539,1046
8,110,83,79476,0,0,RAJASTHAN,Jaipur,VILLAGE,Kanwarpura,Rural,993,624,369,515,158,357
8,110,83,79477,0,0,RAJASTHAN,Jaipur,VILLAGE,Junsya Kalan & Khurd,Rural,1522,940,582,1068,396,672
8,110,83,79478,0,0,RAJASTHAN,Jaipur,VILLAGE,Deva Ka Bas,Rural,830,529,301,458,162,296
8,110,83,79479,0,0,RAJASTHAN,Jaipur,VILLAGE,Deesa,Rural,766,451,315,401,139,262
8,110,83,79480,0,0,RAJASTHAN,Jaipur,VILLAGE,Dholya Ka Bas,Rural,766,508,258,527,177,350
8,110,83,79481,0,0,RAJASTHAN,Jaipur,VILLAGE,Bagawas,Rural,3005,1879,1126,1917,682,1235
8,110,83,79482,0,0,RAJASTHAN,Jaipur,VILLAGE,Lalasar,Rural,2890,1769,1121,1798,681,1117
8,110,83,79483,0,0,RAJASTHAN,Jaipur,VILLAGE,Doongri Khurd,Rural,1838,1163,675,1037,365,672
8,110,83,79484,0,0,RAJASTHAN,Jaipur,VILLAGE,Doongri Kalan,Rural,2213,1386,827,1513,546,967
8,110,83,79485,0,0,RAJASTHAN,Jaipur,VILLAGE,Harsoli,Rural,3006,1866,1140,1774,607,1167
8,110,83,79486,0,0,RAJASTHAN,Jaipur,VILLAGE,Devalya,Rural,746,440,306,404,155,249
8,110,83,79487,0,0,RAJASTHAN,Jaipur,VILLAGE,Doongarsi Ka Bas,Rural,1537,944,593,977,344,633
8,110,83,79488,0,0,RAJASTHAN,Jaipur,VILLAGE,Charanwas,Rural,237,147,90,152,56,96
8,110,83,79489,0,0,RAJASTHAN,Jaipur,VILLAGE,Kesa Ka Bas,Rural,665,360,305,334,150,184
8,110,83,79490,0,0,RAJASTHAN,Jaipur,VILLAGE,Harnathpura,Rural,243,164,79,218,88,130
8,110,83,79491,0,0,RAJASTHAN,Jaipur,VILLAGE,Khijooriya,Rural,580,338,242,274,89,185
8,110,83,79492,0,0,RAJASTHAN,Jaipur,VILLAGE,Ramsinghpura @ Sanga Ka Bas,Rural,536,335,201,335,123,212
8,110,83,79493,0,0,RAJASTHAN,Jaipur,VILLAGE,Mohanpura,Rural,672,436,236,527,188,339
8,110,83,79494,0,0,RAJASTHAN,Jaipur,VILLAGE,Jhalra,Rural,481,268,213,295,118,177
8,110,83,79495,0,0,RAJASTHAN,Jaipur,VILLAGE,Abhaipura,Rural,579,385,194,392,144,248
8,110,83,79496,0,0,RAJASTHAN,Jaipur,VILLAGE,Rampura,Rural,635,413,222,376,133,243
8,110,83,79497,0,0,RAJASTHAN,Jaipur,VILLAGE,Gumanpura,Rural,329,210,119,245,90,155
8,110,83,79498,0,0,RAJASTHAN,Jaipur,VILLAGE,Basri Kalan,Rural,758,470,288,570,212,358
8,110,83,79499,0,0,RAJASTHAN,Jaipur,VILLAGE,Bhainsawa,Rural,3874,2467,1407,3227,1276,1951
8,110,83,79500,0,0,RAJASTHAN,Jaipur,VILLAGE,Beniya Ka Bas,Rural,453,263,190,183,69,114
8,110,83,79501,0,0,RAJASTHAN,Jaipur,VILLAGE,Mohan Ka Bas,Rural,885,550,335,573,205,368
8,110,83,79502,0,0,RAJASTHAN,Jaipur,VILLAGE,Dhana Ka Bas,Rural,675,409,266,428,159,269
8,110,83,79503,0,0,RAJASTHAN,Jaipur,VILLAGE,Karansar,Rural,2143,1290,853,1274,439,835
8,110,83,79504,0,0,RAJASTHAN,Jaipur,VILLAGE,Kheri Milak,Rural,1554,959,595,1038,396,642
8,110,83,79505,0,0,RAJASTHAN,Jaipur,VILLAGE,Loharwara,Rural,1107,689,418,816,301,515
8,110,83,79506,0,0,RAJASTHAN,Jaipur,VILLAGE,Laxmipura,Rural,811,516,295,656,252,404
8,110,83,79507,0,0,RAJASTHAN,Jaipur,VILLAGE,Vijai Govindpura,Rural,425,280,145,402,175,227
8,110,83,79508,0,0,RAJASTHAN,Jaipur,VILLAGE,Kheerwa,Rural,826,499,327,577,204,373
8,110,83,79509,0,0,RAJASTHAN,Jaipur,VILLAGE,Raghunandan Pura,Rural,257,169,88,200,77,123
8,110,83,79510,0,0,RAJASTHAN,Jaipur,VILLAGE,Pachkodiya,Rural,1227,787,440,916,334,582
8,110,83,79511,0,0,RAJASTHAN,Jaipur,VILLAGE,Salagrampura,Rural,145,82,63,108,44,64
8,110,83,79512,0,0,RAJASTHAN,Jaipur,VILLAGE,Ramjipura Khurd,Rural,989,596,393,631,234,397
8,110,83,79513,0,0,RAJASTHAN,Jaipur,VILLAGE,Ramjipura Kalan,Rural,1201,716,485,644,219,425
8,110,83,79514,0,0,RAJASTHAN,Jaipur,VILLAGE,Sunderpura,Rural,936,596,340,600,208,392
8,110,83,79515,0,0,RAJASTHAN,Jaipur,VILLAGE,Mundiya Garh,Rural,1094,690,404,657,215,442
8,110,83,79516,0,0,RAJASTHAN,Jaipur,VILLAGE,Veram Pura,Rural,348,212,136,233,80,153
8,110,83,79517,0,0,RAJASTHAN,Jaipur,VILLAGE,Charanwas,Rural,366,228,138,157,63,94
8,110,83,79518,0,0,RAJASTHAN,Jaipur,VILLAGE,Samdari,Rural,98,63,35,44,21,23
8,110,83,79519,0,0,RAJASTHAN,Jaipur,VILLAGE,Pratappura,Rural,577,363,214,389,148,241
8,110,83,79520,0,0,RAJASTHAN,Jaipur,VILLAGE,Meendi,Rural,417,260,157,226,66,160
8,110,83,79521,0,0,RAJASTHAN,Jaipur,VILLAGE,Nandri,Rural,854,506,348,511,188,323
8,110,83,79522,0,0,RAJASTHAN,Jaipur,VILLAGE,Salehadi Pura,Rural,500,314,186,331,118,213
8,110,83,79523,0,0,RAJASTHAN,Jaipur,VILLAGE,Shyosinghpura @ Gujaron Ka Bas,Rural,244,160,84,292,124,168
8,110,83,79524,0,0,RAJASTHAN,Jaipur,VILLAGE,Sukhalpura,Rural,718,483,235,623,224,399
8,110,83,79525,0,0,RAJASTHAN,Jaipur,VILLAGE,Moondoti,Rural,528,355,173,349,97,252
8,110,83,79526,0,0,RAJASTHAN,Jaipur,VILLAGE,Pratap Pura,Rural,396,243,153,287,100,187
8,110,83,79527,0,0,RAJASTHAN,Jaipur,VILLAGE,Deeppura,Rural,375,237,138,346,129,217
8,110,83,79528,0,0,RAJASTHAN,Jaipur,VILLAGE,Bhojpura Khurd,Rural,519,356,163,391,127,264
8,110,83,79529,0,0,RAJASTHAN,Jaipur,VILLAGE,Anantpura,Rural,765,452,313,577,213,364
8,110,83,79530,0,0,RAJASTHAN,Jaipur,VILLAGE,Manda Bhimsingh,Rural,4367,2643,1724,2958,1052,1906
8,110,83,79531,0,0,RAJASTHAN,Jaipur,VILLAGE,Paharpura,Rural,448,292,156,385,135,250
8,110,83,79532,0,0,RAJASTHAN,Jaipur,VILLAGE,Prempura,Rural,313,224,89,334,121,213
8,110,83,79533,0,0,RAJASTHAN,Jaipur,VILLAGE,Bijarniyon Ka Bas,Rural,290,195,95,208,63,145
8,110,83,79534,0,0,RAJASTHAN,Jaipur,VILLAGE,Bhainslana,Rural,2076,1294,782,1199,432,767
8,110,83,79535,0,0,RAJASTHAN,Jaipur,VILLAGE,Bhookhron Ki Dhani,Rural,736,491,245,607,219,388
8,110,83,79536,0,0,RAJASTHAN,Jaipur,VILLAGE,Sundon Ka Bas,Rural,602,384,218,624,251,373
8,110,83,79537,0,0,RAJASTHAN,Jaipur,VILLAGE,Janiyon Ka Bas,Rural,637,387,250,468,163,305
8,110,83,79538,0,0,RAJASTHAN,Jaipur,VILLAGE,Bhadwa,Rural,3180,1999,1181,2007,682,1325
8,110,83,79539,0,0,RAJASTHAN,Jaipur,VILLAGE,Dogiwalon Ka Bas,Rural,249,154,95,235,89,146
8,110,83,79540,0,0,RAJASTHAN,Jaipur,VILLAGE,Sinodiya,Rural,1082,702,380,759,264,495
8,110,83,79541,0,0,RAJASTHAN,Jaipur,VILLAGE,Panihari,Rural,416,269,147,399,146,253
8,110,83,79542,0,0,RAJASTHAN,Jaipur,VILLAGE,Dodwadiyon Ka Bas,Rural,690,430,260,501,186,315
8,110,83,79543,0,0,RAJASTHAN,Jaipur,VILLAGE,Shyampura,Rural,673,442,231,632,230,402
8,110,83,79544,0,0,RAJASTHAN,Jaipur,VILLAGE,Khatwari Khurd,Rural,373,249,124,319,129,190
8,110,83,79545,0,0,RAJASTHAN,Jaipur,VILLAGE,Khatwari Kalan,Rural,676,446,230,454,150,304
8,110,83,79546,0,0,RAJASTHAN,Jaipur,VILLAGE,Tyoda,Rural,1527,1014,513,1705,680,1025
8,110,83,79547,0,0,RAJASTHAN,Jaipur,VILLAGE,Bag Ki Dhani,Rural,372,242,130,259,71,188
8,110,83,79548,0,0,RAJASTHAN,Jaipur,VILLAGE,Tyod,Rural,1053,643,410,795,282,513
8,110,83,79549,0,0,RAJASTHAN,Jaipur,VILLAGE,Kazipura,Rural,2062,1264,798,1602,600,1002
8,110,83,79550,0,0,RAJASTHAN,Jaipur,VILLAGE,Rasoolpura,Rural,355,221,134,299,120,179
8,110,83,79551,0,0,RAJASTHAN,Jaipur,VILLAGE,Kanwarasa,Rural,1012,628,384,718,252,466
8,110,83,79552,0,0,RAJASTHAN,Jaipur,VILLAGE,Ameepura,Rural,423,272,151,397,152,245
8,110,83,79553,0,0,RAJASTHAN,Jaipur,VILLAGE,Khandel,Rural,1170,714,456,867,315,552
8,110,83,79554,0,0,RAJASTHAN,Jaipur,VILLAGE,Prithvipura,Rural,472,275,197,381,146,235
8,110,83,79555,0,0,RAJASTHAN,Jaipur,VILLAGE,Jaisinghpura,Rural,486,309,177,286,90,196
8,110,83,79556,0,0,RAJASTHAN,Jaipur,VILLAGE,Jaitpura,Rural,1327,841,486,966,327,639
8,110,83,79557,0,0,RAJASTHAN,Jaipur,VILLAGE,Jagmalpura,Rural,419,264,155,224,79,145
8,110,83,79559,0,0,RAJASTHAN,Jaipur,VILLAGE,Machhar Khani,Rural,1128,746,382,691,293,398
8,110,83,79560,0,0,RAJASTHAN,Jaipur,VILLAGE,Dehra,Rural,998,612,386,686,248,438
8,110,83,79561,0,0,RAJASTHAN,Jaipur,VILLAGE,Agarpura,Rural,692,416,276,387,153,234
8,110,83,79562,0,0,RAJASTHAN,Jaipur,VILLAGE,Dhani Nagan,Rural,1921,1165,756,1261,475,786
8,110,83,79563,0,0,RAJASTHAN,Jaipur,VILLAGE,Sunda Ki Dhani,Rural,992,602,390,601,231,370
8,110,83,79564,0,0,RAJASTHAN,Jaipur,VILLAGE,Banshipura,Rural,1136,724,412,828,310,518
8,110,83,79565,0,0,RAJASTHAN,Jaipur,VILLAGE,Baberwalan Ki Dhani,Rural,2468,1494,974,1619,614,1005
8,110,83,79566,0,0,RAJASTHAN,Jaipur,VILLAGE,Jorpura Jobner,Rural,1105,711,394,784,286,498
8,110,83,79567,0,0,RAJASTHAN,Jaipur,VILLAGE,Pratap Pura,Rural,761,477,284,509,193,316
8,110,83,79568,0,0,RAJASTHAN,Jaipur,VILLAGE,Saipura,Rural,120,78,42,120,53,67
8,110,83,79569,0,0,RAJASTHAN,Jaipur,VILLAGE,Manoharpura,Rural,64,36,28,42,18,24
8,110,83,79570,0,0,RAJASTHAN,Jaipur,VILLAGE,Singhpuri,Rural,70,43,27,50,22,28
8,110,83,79571,0,0,RAJASTHAN,Jaipur,VILLAGE,Moondwara,Rural,1050,689,361,975,364,611
8,110,83,79572,0,0,RAJASTHAN,Jaipur,VILLAGE,Korhi,Rural,908,531,377,506,203,303
8,110,83,79573,0,0,RAJASTHAN,Jaipur,VILLAGE,Shambhoopura,Rural,90,52,38,69,27,42
8,110,83,79574,0,0,RAJASTHAN,Jaipur,VILLAGE,Dyodhi,Rural,1165,726,439,859,322,537
8,110,83,79575,0,0,RAJASTHAN,Jaipur,VILLAGE,Geeda Ka Bas,Rural,150,105,45,161,55,106
8,110,83,79576,0,0,RAJASTHAN,Jaipur,VILLAGE,Aidan Ka Bas,Rural,407,247,160,316,137,179
8,110,83,79577,0,0,RAJASTHAN,Jaipur,VILLAGE,Charanwas,Rural,321,199,122,282,103,179
8,110,83,79578,0,0,RAJASTHAN,Jaipur,VILLAGE,Turkyabas,Rural,273,180,93,180,53,127
8,110,83,79579,0,0,RAJASTHAN,Jaipur,VILLAGE,Bhojpura Kalan,Rural,1832,1154,678,1145,368,777
8,110,83,79580,0,0,RAJASTHAN,Jaipur,VILLAGE,Chirnotiya,Rural,436,270,166,253,88,165
8,110,83,79581,0,0,RAJASTHAN,Jaipur,VILLAGE,Murlipura,Rural,1213,727,486,889,352,537
8,110,83,79582,0,0,RAJASTHAN,Jaipur,VILLAGE,Thakursi Ka Bas,Rural,570,330,240,277,88,189
8,110,83,79583,0,0,RAJASTHAN,Jaipur,VILLAGE,Doongri,Rural,1440,876,564,935,334,601
8,110,83,79584,0,0,RAJASTHAN,Jaipur,VILLAGE,Ala Ka Bas,Rural,752,443,309,493,192,301
8,110,83,79585,0,0,RAJASTHAN,Jaipur,VILLAGE,Hingoniya,Rural,3903,2303,1600,2244,863,1381
8,110,83,79586,0,0,RAJASTHAN,Jaipur,VILLAGE,Kudiyon Ka Bas,Rural,727,433,294,434,153,281
8,110,83,79587,0,0,RAJASTHAN,Jaipur,VILLAGE,Gurha Mansingh,Rural,1125,721,404,686,230,456
8,110,83,79588,0,0,RAJASTHAN,Jaipur,VILLAGE,Sundariyawas,Rural,800,481,319,467,173,294
8,110,83,79589,0,0,RAJASTHAN,Jaipur,VILLAGE,Jorpura,Rural,1048,641,407,466,153,313
8,110,83,79590,0,0,RAJASTHAN,Jaipur,VILLAGE,Tibariya,Rural,703,429,274,449,160,289
8,110,83,79591,0,0,RAJASTHAN,Jaipur,VILLAGE,Bassinaga,Rural,1513,946,567,1056,382,674
8,110,83,79592,0,0,RAJASTHAN,Jaipur,VILLAGE,Kuchyawas,Rural,391,251,140,237,78,159
8,110,83,79593,0,0,RAJASTHAN,Jaipur,VILLAGE,Joshiwas,Rural,234,150,84,212,82,130
8,110,83,79594,0,0,RAJASTHAN,Jaipur,VILLAGE,Khejrawas,Rural,660,389,271,460,170,290
8,110,83,79595,0,0,RAJASTHAN,Jaipur,VILLAGE,Bhikhawas,Rural,643,372,271,319,130,189
8,110,83,79596,0,0,RAJASTHAN,Jaipur,VILLAGE,Roopsingh Ka Bas,Rural,90,53,37,24,9,15
8,110,83,79597,0,0,RAJASTHAN,Jaipur,VILLAGE,Sankhla Ka Bas,Rural,372,202,170,181,92,89
8,110,83,79598,0,0,RAJASTHAN,Jaipur,VILLAGE,Ramsinghpura,Rural,167,105,62,82,29,53
8,110,83,79599,0,0,RAJASTHAN,Jaipur,VILLAGE,Chak Jobner,Rural,82,52,30,58,18,40
8,110,83,79600,0,0,RAJASTHAN,Jaipur,VILLAGE,Kalakh,Rural,1711,1103,608,1287,430,857
8,110,83,79601,0,0,RAJASTHAN,Jaipur,VILLAGE,Ganeshpura,Rural,157,102,55,103,34,69
8,110,83,79602,0,0,RAJASTHAN,Jaipur,VILLAGE,Bagron Ka Bas,Rural,170,102,68,144,54,90
8,110,83,79603,0,0,RAJASTHAN,Jaipur,VILLAGE,Haripura,Rural,509,320,189,248,92,156
8,110,83,79611,0,0,RAJASTHAN,Jaipur,VILLAGE,Gokulpura,Rural,850,541,309,655,244,411
8,110,83,79627,0,0,RAJASTHAN,Jaipur,VILLAGE,Peepli Ka Bas,Rural,808,502,306,462,150,312
8,110,83,79628,0,0,RAJASTHAN,Jaipur,VILLAGE,Norangpura,Rural,1276,802,474,1128,424,704
8,110,83,79629,0,0,RAJASTHAN,Jaipur,VILLAGE,Shivaniya,Rural,163,100,63,159,56,103
8,110,83,79630,0,0,RAJASTHAN,Jaipur,VILLAGE,Tejya Ka Bas,Rural,1602,978,624,1031,342,689
8,110,83,79631,0,0,RAJASTHAN,Jaipur,VILLAGE,Bhadear Pura,Rural,680,444,236,450,152,298
8,110,83,79632,0,0,RAJASTHAN,Jaipur,VILLAGE,Itawa,Rural,933,581,352,594,208,386
8,110,83,79697,0,0,RAJASTHAN,Jaipur,VILLAGE,Mundalee Ranjeetpura,Rural,1670,1093,577,1259,469,790
8,110,83,79698,0,0,RAJASTHAN,Jaipur,VILLAGE,Ramsinghpura @ Dodiyan,Rural,409,262,147,269,97,172
8,110,84,0,0,0,RAJASTHAN,Jaipur,CD BLOCK,Phagi,Total,100730,64322,36408,90396,34904,55492
8,110,84,0,0,0,RAJASTHAN,Jaipur,CD BLOCK,Phagi,Rural,100730,64322,36408,90396,34904,55492
8,110,84,0,0,0,RAJASTHAN,Jaipur,CD BLOCK,Phagi,Urban,0,0,0,0,0,0
8,110,84,79856,0,0,RAJASTHAN,Jaipur,VILLAGE,Bookni,Rural,291,192,99,227,73,154
8,110,84,79857,0,0,RAJASTHAN,Jaipur,VILLAGE,Hingoniya,Rural,177,106,71,134,53,81
8,110,84,79858,0,0,RAJASTHAN,Jaipur,VILLAGE,Nandlalpura,Rural,317,188,129,328,119,209
8,110,84,79859,0,0,RAJASTHAN,Jaipur,VILLAGE,Sherpura,Rural,303,184,119,200,73,127
8,110,84,79860,0,0,RAJASTHAN,Jaipur,VILLAGE,Sawai Jaisinghpura,Rural,620,401,219,717,291,426
8,110,84,79861,0,0,RAJASTHAN,Jaipur,VILLAGE,Chhardara,Rural,204,116,88,86,36,50
8,110,84,79862,0,0,RAJASTHAN,Jaipur,VILLAGE,Govindpura @ Basra,Rural,209,130,79,328,156,172
8,110,84,79863,0,0,RAJASTHAN,Jaipur,VILLAGE,Rata Khera,Rural,331,224,107,301,102,199
8,110,84,79864,0,0,RAJASTHAN,Jaipur,VILLAGE,Kansel,Rural,714,466,248,574,231,343
8,110,84,79865,0,0,RAJASTHAN,Jaipur,VILLAGE,Jagat Shiromanipura @ Manpura,Rural,173,115,58,170,68,102
8,110,84,79866,0,0,RAJASTHAN,Jaipur,VILLAGE,Sanwal,Rural,360,236,124,280,94,186
8,110,84,79867,0,0,RAJASTHAN,Jaipur,VILLAGE,Kunj Biharipura,Rural,268,166,102,156,60,96
8,110,84,79868,0,0,RAJASTHAN,Jaipur,VILLAGE,Rotwara,Rural,279,158,121,161,67,94
8,110,84,79869,0,0,RAJASTHAN,Jaipur,VILLAGE,Koonchyawas,Rural,337,202,135,289,100,189
8,110,84,79870,0,0,RAJASTHAN,Jaipur,VILLAGE,Bheempura,Rural,339,222,117,450,196,254
8,110,84,79871,0,0,RAJASTHAN,Jaipur,VILLAGE,Madanpura @ Katariya Ka Bas,Rural,32,19,13,29,8,21
8,110,84,79872,0,0,RAJASTHAN,Jaipur,VILLAGE,Gulabpura,Rural,140,97,43,83,26,57
8,110,84,79873,0,0,RAJASTHAN,Jaipur,VILLAGE,Rampura @ Chokhawala,Rural,252,162,90,139,45,94
8,110,84,79874,0,0,RAJASTHAN,Jaipur,VILLAGE,Jabar,Rural,508,317,191,445,175,270
8,110,84,79875,0,0,RAJASTHAN,Jaipur,VILLAGE,Raithal,Rural,379,240,139,365,136,229
8,110,84,79876,0,0,RAJASTHAN,Jaipur,VILLAGE,Harbanshpura,Rural,220,143,77,284,118,166
8,110,84,79877,0,0,RAJASTHAN,Jaipur,VILLAGE,Keeratpura,Rural,357,235,122,326,128,198
8,110,84,79878,0,0,RAJASTHAN,Jaipur,VILLAGE,Amarpura,Rural,151,90,61,111,42,69
8,110,84,79879,0,0,RAJASTHAN,Jaipur,VILLAGE,Sawa Ka Bas,Rural,508,304,204,589,253,336
8,110,84,79880,0,0,RAJASTHAN,Jaipur,VILLAGE,Mandor,Rural,746,475,271,579,199,380
8,110,84,79881,0,0,RAJASTHAN,Jaipur,VILLAGE,Teekel Narukan,Rural,624,414,210,595,233,362
8,110,84,79882,0,0,RAJASTHAN,Jaipur,VILLAGE,Salarsoo,Rural,213,137,76,220,93,127
8,110,84,79883,0,0,RAJASTHAN,Jaipur,VILLAGE,Pinach,Rural,432,307,125,652,251,401
8,110,84,79884,0,0,RAJASTHAN,Jaipur,VILLAGE,Rewantpura,Rural,244,181,63,455,171,284
8,110,84,79885,0,0,RAJASTHAN,Jaipur,VILLAGE,Teekel Purohitan,Rural,405,252,153,362,148,214
8,110,84,79886,0,0,RAJASTHAN,Jaipur,VILLAGE,Awandiya,Rural,537,337,200,548,208,340
8,110,84,79887,0,0,RAJASTHAN,Jaipur,VILLAGE,Pachala,Rural,528,331,197,740,327,413
8,110,84,79888,0,0,RAJASTHAN,Jaipur,VILLAGE,Jhodinda Bhojpura,Rural,872,536,336,474,173,301
8,110,84,79889,0,0,RAJASTHAN,Jaipur,VILLAGE,Shankarpura,Rural,604,380,224,442,160,282
8,110,84,79890,0,0,RAJASTHAN,Jaipur,VILLAGE,Chainpura @ Bharatpura,Rural,202,134,68,258,103,155
8,110,84,79891,0,0,RAJASTHAN,Jaipur,VILLAGE,Chauru,Rural,3185,2027,1158,2619,979,1640
8,110,84,79892,0,0,RAJASTHAN,Jaipur,VILLAGE,Chakwara,Rural,2833,1719,1114,1635,587,1048
8,110,84,79893,0,0,RAJASTHAN,Jaipur,VILLAGE,Sultaniya,Rural,880,582,298,983,399,584
8,110,84,79894,0,0,RAJASTHAN,Jaipur,VILLAGE,Deonagar,Rural,390,269,121,456,179,277
8,110,84,79895,0,0,RAJASTHAN,Jaipur,VILLAGE,Ladana,Rural,1298,831,467,1349,551,798
8,110,84,79896,0,0,RAJASTHAN,Jaipur,VILLAGE,Rampura,Rural,0,0,0,0,0,0
8,110,84,79897,0,0,RAJASTHAN,Jaipur,VILLAGE,Balapura,Rural,550,369,181,693,285,408
8,110,84,79898,0,0,RAJASTHAN,Jaipur,VILLAGE,Nawal Kishorpura,Rural,220,143,77,237,98,139
8,110,84,79899,0,0,RAJASTHAN,Jaipur,VILLAGE,Gohandi,Rural,812,530,282,694,251,443
8,110,84,79900,0,0,RAJASTHAN,Jaipur,VILLAGE,Chak Gulabpura,Rural,9,3,6,2,0,2
8,110,84,79901,0,0,RAJASTHAN,Jaipur,VILLAGE,Jankinathpura,Rural,209,122,87,151,52,99
8,110,84,79902,0,0,RAJASTHAN,Jaipur,VILLAGE,Heerapura,Rural,716,423,293,479,186,293
8,110,84,79903,0,0,RAJASTHAN,Jaipur,VILLAGE,Nihalpura @ Miyan Ka Barh,Rural,0,0,0,0,0,0
8,110,84,79904,0,0,RAJASTHAN,Jaipur,VILLAGE,Karwa,Rural,103,73,30,85,34,51
8,110,84,79905,0,0,RAJASTHAN,Jaipur,VILLAGE,Hari Rampura,Rural,271,186,85,224,82,142
8,110,84,79906,0,0,RAJASTHAN,Jaipur,VILLAGE,Beer Ramchandrapura,Rural,362,255,107,384,146,238
8,110,84,79907,0,0,RAJASTHAN,Jaipur,VILLAGE,Renwal Manji,Rural,4336,2667,1669,2903,1125,1778
8,110,84,79908,0,0,RAJASTHAN,Jaipur,VILLAGE,Daloowala,Rural,315,184,131,210,73,137
8,110,84,79909,0,0,RAJASTHAN,Jaipur,VILLAGE,Kishanpura,Rural,275,188,87,224,78,146
8,110,84,79910,0,0,RAJASTHAN,Jaipur,VILLAGE,Raipura,Rural,307,192,115,240,94,146
8,110,84,79911,0,0,RAJASTHAN,Jaipur,VILLAGE,Gopal Nagar,Rural,824,538,286,983,388,595
8,110,84,79912,0,0,RAJASTHAN,Jaipur,VILLAGE,Khejra Ka Bas,Rural,93,63,30,96,40,56
8,110,84,79913,0,0,RAJASTHAN,Jaipur,VILLAGE,Harsooliya,Rural,1533,944,589,1353,541,812
8,110,84,79914,0,0,RAJASTHAN,Jaipur,VILLAGE,Mohanpura Prathvisingh,Rural,722,465,257,671,261,410
8,110,84,79915,0,0,RAJASTHAN,Jaipur,VILLAGE,Jaichand Ka Bas,Rural,286,186,100,426,169,257
8,110,84,79916,0,0,RAJASTHAN,Jaipur,VILLAGE,Thala,Rural,1135,773,362,1499,627,872
8,110,84,79917,0,0,RAJASTHAN,Jaipur,VILLAGE,Bhojpura,Rural,833,537,296,1063,421,642
8,110,84,79918,0,0,RAJASTHAN,Jaipur,VILLAGE,Barh-Bishanpura @ Kagya,Rural,200,105,95,258,114,144
8,110,84,79919,0,0,RAJASTHAN,Jaipur,VILLAGE,Phagi,Rural,7566,4656,2910,5116,1883,3233
8,110,84,79920,0,0,RAJASTHAN,Jaipur,VILLAGE,Lasariya,Rural,1368,882,486,1553,605,948
8,110,84,79921,0,0,RAJASTHAN,Jaipur,VILLAGE,Palri,Rural,315,204,111,304,128,176
8,110,84,79922,0,0,RAJASTHAN,Jaipur,VILLAGE,Nari Khera,Rural,188,131,57,174,69,105
8,110,84,79923,0,0,RAJASTHAN,Jaipur,VILLAGE,Nareda,Rural,1213,790,423,1202,447,755
8,110,84,79924,0,0,RAJASTHAN,Jaipur,VILLAGE,Chhapri,Rural,705,487,218,702,248,454
8,110,84,79925,0,0,RAJASTHAN,Jaipur,VILLAGE,Mandawari,Rural,884,573,311,825,310,515
8,110,84,79926,0,0,RAJASTHAN,Jaipur,VILLAGE,Ganeshpura Faujiyan,Rural,13,8,5,3,2,1
8,110,84,79927,0,0,RAJASTHAN,Jaipur,VILLAGE,Gulabpura @ Gopalpura,Rural,204,131,73,223,87,136
8,110,84,79928,0,0,RAJASTHAN,Jaipur,VILLAGE,Ghatiyali,Rural,644,424,220,723,275,448
8,110,84,79929,0,0,RAJASTHAN,Jaipur,VILLAGE,Mandawara,Rural,926,587,339,839,319,520
8,110,84,79930,0,0,RAJASTHAN,Jaipur,VILLAGE,Hachookara,Rural,302,203,99,301,105,196
8,110,84,79931,0,0,RAJASTHAN,Jaipur,VILLAGE,Dalniya,Rural,474,319,155,394,134,260
8,110,84,79932,0,0,RAJASTHAN,Jaipur,VILLAGE,Kudli,Rural,903,613,290,1293,520,773
8,110,84,79933,0,0,RAJASTHAN,Jaipur,VILLAGE,Dhuwaliya,Rural,134,87,47,180,74,106
8,110,84,79934,0,0,RAJASTHAN,Jaipur,VILLAGE,Kansya,Rural,485,328,157,526,179,347
8,110,84,79935,0,0,RAJASTHAN,Jaipur,VILLAGE,Mendwas,Rural,1614,1078,536,1381,482,899
8,110,84,79936,0,0,RAJASTHAN,Jaipur,VILLAGE,Sirsya,Rural,425,268,157,416,160,256
8,110,84,79937,0,0,RAJASTHAN,Jaipur,VILLAGE,Maharajpura @ Nainasya,Rural,327,230,97,338,113,225
8,110,84,79938,0,0,RAJASTHAN,Jaipur,VILLAGE,Jaisinghpura @ Gadoora,Rural,475,310,165,525,216,309
8,110,84,79939,0,0,RAJASTHAN,Jaipur,VILLAGE,Nimera,Rural,2477,1627,850,2302,874,1428
8,110,84,79940,0,0,RAJASTHAN,Jaipur,VILLAGE,Shri Ramganj,Rural,548,366,182,600,225,375
8,110,84,79941,0,0,RAJASTHAN,Jaipur,VILLAGE,Jagannathapura,Rural,197,127,70,202,78,124
8,110,84,79942,0,0,RAJASTHAN,Jaipur,VILLAGE,Bimalpura,Rural,300,172,128,265,109,156
8,110,84,79943,0,0,RAJASTHAN,Jaipur,VILLAGE,Ramchandrapura,Rural,170,104,66,199,85,114
8,110,84,79944,0,0,RAJASTHAN,Jaipur,VILLAGE,Barh Ramchandrapura,Rural,0,0,0,0,0,0
8,110,84,79945,0,0,RAJASTHAN,Jaipur,VILLAGE,Kishorpura,Rural,438,308,130,481,159,322
8,110,84,79946,0,0,RAJASTHAN,Jaipur,VILLAGE,Mohanpura Rajawatan,Rural,612,435,177,628,257,371
8,110,84,79947,0,0,RAJASTHAN,Jaipur,VILLAGE,Sameliya,Rural,548,357,191,603,264,339
8,110,84,79948,0,0,RAJASTHAN,Jaipur,VILLAGE,Mordi,Rural,265,171,94,223,76,147
8,110,84,79949,0,0,RAJASTHAN,Jaipur,VILLAGE,Barh Mordi,Rural,14,10,4,3,0,3
8,110,84,79950,0,0,RAJASTHAN,Jaipur,VILLAGE,Lakhawas,Rural,96,64,32,100,43,57
8,110,84,79951,0,0,RAJASTHAN,Jaipur,VILLAGE,Parwan,Rural,552,346,206,415,161,254
8,110,84,79952,0,0,RAJASTHAN,Jaipur,VILLAGE,Gokulpura,Rural,326,194,132,178,81,97
8,110,84,79953,0,0,RAJASTHAN,Jaipur,VILLAGE,Khandooj,Rural,370,219,151,241,98,143
8,110,84,79954,0,0,RAJASTHAN,Jaipur,VILLAGE,Dwarkanathpura @ Keriya,Rural,318,204,114,337,132,205
8,110,84,79955,0,0,RAJASTHAN,Jaipur,VILLAGE,Madanpura,Rural,257,178,79,280,103,177
8,110,84,79956,0,0,RAJASTHAN,Jaipur,VILLAGE,Kanwarpura,Rural,139,88,51,109,43,66
8,110,84,79957,0,0,RAJASTHAN,Jaipur,VILLAGE,Ratanpura,Rural,331,218,113,413,165,248
8,110,84,79958,0,0,RAJASTHAN,Jaipur,VILLAGE,Nathmalpura,Rural,327,226,101,359,133,226
8,110,84,79959,0,0,RAJASTHAN,Jaipur,VILLAGE,Mandi,Rural,594,400,194,518,194,324
8,110,84,79960,0,0,RAJASTHAN,Jaipur,VILLAGE,Rampura Railway,Rural,262,164,98,231,74,157
8,110,84,79961,0,0,RAJASTHAN,Jaipur,VILLAGE,Mohanpura Ranwa,Rural,439,292,147,362,134,228
8,110,84,79962,0,0,RAJASTHAN,Jaipur,VILLAGE,Datooli,Rural,740,470,270,727,291,436
8,110,84,79963,0,0,RAJASTHAN,Jaipur,VILLAGE,Jhadla,Rural,641,410,231,605,229,376
8,110,84,79964,0,0,RAJASTHAN,Jaipur,VILLAGE,Kantoli,Rural,121,85,36,135,49,86
8,110,84,79965,0,0,RAJASTHAN,Jaipur,VILLAGE,Mandaliya Joga,Rural,331,226,105,278,102,176
8,110,84,79966,0,0,RAJASTHAN,Jaipur,VILLAGE,Khijooriya,Rural,483,312,171,486,188,298
8,110,84,79967,0,0,RAJASTHAN,Jaipur,VILLAGE,Jharana Khurd,Rural,279,175,104,202,81,121
8,110,84,79968,0,0,RAJASTHAN,Jaipur,VILLAGE,Jhonpariya,Rural,225,159,66,285,127,158
8,110,84,79969,0,0,RAJASTHAN,Jaipur,VILLAGE,Jharana,Rural,420,244,176,267,93,174
8,110,84,79970,0,0,RAJASTHAN,Jaipur,VILLAGE,Madhorajpura,Rural,3460,2049,1411,1832,682,1150
8,110,84,79971,0,0,RAJASTHAN,Jaipur,VILLAGE,Khera Hanumanji,Rural,210,135,75,251,103,148
8,110,84,79972,0,0,RAJASTHAN,Jaipur,VILLAGE,Harsundarpura @ Hatheli,Rural,446,276,170,372,158,214
8,110,84,79973,0,0,RAJASTHAN,Jaipur,VILLAGE,Panwasoo Khera,Rural,297,191,106,265,96,169
8,110,84,79974,0,0,RAJASTHAN,Jaipur,VILLAGE,Ajnota,Rural,273,176,97,309,136,173
8,110,84,79975,0,0,RAJASTHAN,Jaipur,VILLAGE,Dhunwaliya,Rural,475,304,171,537,221,316
8,110,84,79976,0,0,RAJASTHAN,Jaipur,VILLAGE,Mandap,Rural,285,192,93,381,155,226
8,110,84,79977,0,0,RAJASTHAN,Jaipur,VILLAGE,Chandama Khurd,Rural,349,229,120,422,179,243
8,110,84,79978,0,0,RAJASTHAN,Jaipur,VILLAGE,Chandarpura,Rural,368,246,122,539,208,331
8,110,84,79979,0,0,RAJASTHAN,Jaipur,VILLAGE,Chandama Kalan,Rural,1250,846,404,1246,461,785
8,110,84,79980,0,0,RAJASTHAN,Jaipur,VILLAGE,Unt Ka Khera,Rural,176,115,61,226,91,135
8,110,84,79981,0,0,RAJASTHAN,Jaipur,VILLAGE,Beechi,Rural,1315,865,450,1698,691,1007
8,110,84,79982,0,0,RAJASTHAN,Jaipur,VILLAGE,Jugal Kishorpura,Rural,29,22,7,31,12,19
8,110,84,79983,0,0,RAJASTHAN,Jaipur,VILLAGE,Bhankrota,Rural,779,483,296,654,257,397
8,110,84,79984,0,0,RAJASTHAN,Jaipur,VILLAGE,Peepla,Rural,1691,1044,647,1587,662,925
8,110,84,79985,0,0,RAJASTHAN,Jaipur,VILLAGE,Veerampura,Rural,318,217,101,332,132,200
8,110,84,79986,0,0,RAJASTHAN,Jaipur,VILLAGE,Chittora,Rural,2006,1297,709,1822,712,1110
8,110,84,79987,0,0,RAJASTHAN,Jaipur,VILLAGE,Pratappura,Rural,468,306,162,504,199,305
8,110,84,79988,0,0,RAJASTHAN,Jaipur,VILLAGE,Shrirajpura,Rural,324,237,87,364,138,226
8,110,84,79989,0,0,RAJASTHAN,Jaipur,VILLAGE,Manpur Gate,Rural,449,293,156,338,117,221
8,110,84,79990,0,0,RAJASTHAN,Jaipur,VILLAGE,Chandawas,Rural,311,188,123,345,162,183
8,110,84,79991,0,0,RAJASTHAN,Jaipur,VILLAGE,Ganeshpura,Rural,317,207,110,254,97,157
8,110,84,79992,0,0,RAJASTHAN,Jaipur,VILLAGE,Dabla Khurd,Rural,481,287,194,372,134,238
8,110,84,79993,0,0,RAJASTHAN,Jaipur,VILLAGE,Dabla Bujurg,Rural,829,521,308,560,194,366
8,110,84,79994,0,0,RAJASTHAN,Jaipur,VILLAGE,Basri Jogiyan,Rural,802,514,288,662,254,408
8,110,84,79995,0,0,RAJASTHAN,Jaipur,VILLAGE,Mohabbat Pura,Rural,758,485,273,783,301,482
8,110,84,79996,0,0,RAJASTHAN,Jaipur,VILLAGE,Bawari Kaushalya Das,Rural,269,179,90,182,51,131
8,110,84,79997,0,0,RAJASTHAN,Jaipur,VILLAGE,Kundan Pura,Rural,485,303,182,498,207,291
8,110,84,79998,0,0,RAJASTHAN,Jaipur,VILLAGE,Pahariya,Rural,1121,714,407,949,375,574
8,110,84,79999,0,0,RAJASTHAN,Jaipur,VILLAGE,Narayan Pura,Rural,656,470,186,583,186,397
8,110,84,80000,0,0,RAJASTHAN,Jaipur,VILLAGE,Sitarampura,Rural,461,320,141,452,153,299
8,110,84,80001,0,0,RAJASTHAN,Jaipur,VILLAGE,Shri Jaipalpura @ Goojronwala,Rural,224,149,75,235,93,142
8,110,84,80002,0,0,RAJASTHAN,Jaipur,VILLAGE,Barhali,Rural,268,185,83,304,115,189
8,110,84,80003,0,0,RAJASTHAN,Jaipur,VILLAGE,Bokrawas,Rural,489,303,186,336,119,217
8,110,84,80004,0,0,RAJASTHAN,Jaipur,VILLAGE,Mustafabad @ Masta,Rural,354,220,134,284,115,169
8,110,84,80005,0,0,RAJASTHAN,Jaipur,VILLAGE,Deomand,Rural,273,168,105,190,60,130
8,110,84,80006,0,0,RAJASTHAN,Jaipur,VILLAGE,Dabich Maliyan,Rural,312,197,115,295,122,173
8,110,84,80007,0,0,RAJASTHAN,Jaipur,VILLAGE,Dabich Goojaran,Rural,323,230,93,444,164,280
8,110,84,80008,0,0,RAJASTHAN,Jaipur,VILLAGE,Fateh Rampura,Rural,269,183,86,296,127,169
8,110,84,80009,0,0,RAJASTHAN,Jaipur,VILLAGE,Dabich,Rural,700,431,269,422,151,271
8,110,84,80010,0,0,RAJASTHAN,Jaipur,VILLAGE,Shri Ramjipura,Rural,374,245,129,317,122,195
8,110,84,80011,0,0,RAJASTHAN,Jaipur,VILLAGE,Ramsinghpura,Rural,156,106,50,144,51,93
8,110,84,80012,0,0,RAJASTHAN,Jaipur,VILLAGE,Gopalpura,Rural,806,474,332,635,223,412
8,110,84,80013,0,0,RAJASTHAN,Jaipur,VILLAGE,Dosra,Rural,724,435,289,511,209,302
8,110,84,80014,0,0,RAJASTHAN,Jaipur,VILLAGE,Dosra Khurd,Rural,219,136,83,167,59,108
8,110,84,80015,0,0,RAJASTHAN,Jaipur,VILLAGE,Prempura,Rural,36,18,18,24,8,16
8,110,84,80016,0,0,RAJASTHAN,Jaipur,VILLAGE,Sehdariya,Rural,766,454,312,667,260,407
8,110,84,80017,0,0,RAJASTHAN,Jaipur,VILLAGE,Muratpura,Rural,210,139,71,155,60,95
8,110,84,80018,0,0,RAJASTHAN,Jaipur,VILLAGE,Bhanpura,Rural,558,369,189,490,173,317
8,110,84,80019,0,0,RAJASTHAN,Jaipur,VILLAGE,Sangrampura,Rural,47,31,16,127,57,70
8,110,84,80020,0,0,RAJASTHAN,Jaipur,VILLAGE,Bisaloo,Rural,788,534,254,870,347,523
8,110,84,80021,0,0,RAJASTHAN,Jaipur,VILLAGE,Hanootiya Kalan,Rural,102,75,27,194,88,106
8,110,84,80022,0,0,RAJASTHAN,Jaipur,VILLAGE,Hanootiya Khurd,Rural,704,411,293,311,133,178
8,110,84,80023,0,0,RAJASTHAN,Jaipur,VILLAGE,Mukand Pura,Rural,792,453,339,562,236,326
8,110,84,80024,0,0,RAJASTHAN,Jaipur,VILLAGE,Didawata,Rural,1491,959,532,1138,442,696
8,110,84,80025,0,0,RAJASTHAN,Jaipur,VILLAGE,Govindpura @ Mandaliya,Rural,382,230,152,515,229,286
8,110,84,80026,0,0,RAJASTHAN,Jaipur,VILLAGE,Nondpura,Rural,133,97,36,144,54,90
8,110,84,80027,0,0,RAJASTHAN,Jaipur,VILLAGE,Sarswati Pura,Rural,214,148,66,203,83,120
8,110,85,0,0,0,RAJASTHAN,Jaipur,CD BLOCK,Sanganer,Total,107351,64714,42637,67542,25584,41958
8,110,85,0,0,0,RAJASTHAN,Jaipur,CD BLOCK,Sanganer,Rural,107351,64714,42637,67542,25584,41958
8,110,85,0,0,0,RAJASTHAN,Jaipur,CD BLOCK,Sanganer,Urban,0,0,0,0,0,0
8,110,85,80028,0,0,RAJASTHAN,Jaipur,VILLAGE,Sitapura Bas Sanjhariya,Rural,0,0,0,0,0,0
8,110,85,80029,0,0,RAJASTHAN,Jaipur,VILLAGE,Sanjariya,Rural,1620,919,701,959,380,579
8,110,85,80030,0,0,RAJASTHAN,Jaipur,VILLAGE,Hardhyanpura,Rural,488,304,184,310,104,206
8,110,85,80031,0,0,RAJASTHAN,Jaipur,VILLAGE,Dahmi Khurd,Rural,567,340,227,307,121,186
8,110,85,80032,0,0,RAJASTHAN,Jaipur,VILLAGE,Dahmi Kalan,Rural,3819,2251,1568,2031,699,1332
8,110,85,80033,0,0,RAJASTHAN,Jaipur,VILLAGE,Ghegha,Rural,555,343,212,310,109,201
8,110,85,80034,0,0,RAJASTHAN,Jaipur,VILLAGE,Chimanpura,Rural,288,189,99,188,54,134
8,110,85,80035,0,0,RAJASTHAN,Jaipur,VILLAGE,Bhaosinghpura,Rural,46,32,14,30,9,21
8,110,85,80036,0,0,RAJASTHAN,Jaipur,VILLAGE,Barh Awaniya,Rural,80,53,27,72,30,42
8,110,85,80037,0,0,RAJASTHAN,Jaipur,VILLAGE,Awaniya,Rural,777,509,268,520,163,357
8,110,85,80038,0,0,RAJASTHAN,Jaipur,VILLAGE,Kodar,Rural,975,635,340,687,231,456
8,110,85,80039,0,0,RAJASTHAN,Jaipur,VILLAGE,Bagru Rawan,Rural,503,299,204,230,93,137
8,110,85,80040,0,0,RAJASTHAN,Jaipur,VILLAGE,Chhitroli,Rural,728,482,246,555,198,357
8,110,85,80041,0,0,RAJASTHAN,Jaipur,VILLAGE,Shyosinghpura,Rural,586,360,226,372,135,237
8,110,85,80042,0,0,RAJASTHAN,Jaipur,VILLAGE,Rampura Unti,Rural,1359,840,519,961,339,622
8,110,85,80043,0,0,RAJASTHAN,Jaipur,VILLAGE,Jhund,Rural,571,316,255,251,118,133
8,110,85,80044,0,0,RAJASTHAN,Jaipur,VILLAGE,Anoppura,Rural,370,227,143,153,49,104
8,110,85,80045,0,0,RAJASTHAN,Jaipur,VILLAGE,Lakshminarayanpura,Rural,590,326,264,216,94,122
8,110,85,80046,0,0,RAJASTHAN,Jaipur,VILLAGE,Narwariya,Rural,485,291,194,243,87,156
8,110,85,80047,0,0,RAJASTHAN,Jaipur,VILLAGE,Bhankrota Khurd,Rural,555,334,221,413,157,256
8,110,85,80048,0,0,RAJASTHAN,Jaipur,VILLAGE,Ramdattpura,Rural,254,150,104,210,82,128
8,110,85,80049,0,0,RAJASTHAN,Jaipur,VILLAGE,Hariharpura,Rural,77,44,33,33,12,21
8,110,85,80050,0,0,RAJASTHAN,Jaipur,VILLAGE,Barh Ajairajpura,Rural,0,0,0,0,0,0
8,110,85,80051,0,0,RAJASTHAN,Jaipur,VILLAGE,Jagannathpura,Rural,200,127,73,165,74,91
8,110,85,80052,0,0,RAJASTHAN,Jaipur,VILLAGE,Devisinghpura,Rural,190,114,76,115,51,64
8,110,85,80053,0,0,RAJASTHAN,Jaipur,VILLAGE,Sirani,Rural,1128,672,456,765,309,456
8,110,85,80054,0,0,RAJASTHAN,Jaipur,VILLAGE,Suratpura,Rural,420,275,145,360,128,232
8,110,85,80055,0,0,RAJASTHAN,Jaipur,VILLAGE,Ajairajpura,Rural,884,551,333,826,337,489
8,110,85,80056,0,0,RAJASTHAN,Jaipur,VILLAGE,Barh Hariharpura,Rural,0,0,0,0,0,0
8,110,85,80057,0,0,RAJASTHAN,Jaipur,VILLAGE,Lakhawas,Rural,200,120,80,200,80,120
8,110,85,80058,0,0,RAJASTHAN,Jaipur,VILLAGE,Jaijaspura,Rural,264,148,116,138,55,83
8,110,85,80059,0,0,RAJASTHAN,Jaipur,VILLAGE,Hasampura,Rural,317,181,136,182,69,113
8,110,85,80060,0,0,RAJASTHAN,Jaipur,VILLAGE,Chirota,Rural,565,325,240,304,114,190
8,110,85,80061,0,0,RAJASTHAN,Jaipur,VILLAGE,Palri Parsa,Rural,449,284,165,367,142,225
8,110,85,80062,0,0,RAJASTHAN,Jaipur,VILLAGE,Narsinghpura @ Dadiya,Rural,125,75,50,115,50,65
8,110,85,80063,0,0,RAJASTHAN,Jaipur,VILLAGE,Kalwara,Rural,2020,1227,793,1559,627,932
8,110,85,80064,0,0,RAJASTHAN,Jaipur,VILLAGE,Bhambhoriya,Rural,1555,993,562,888,315,573
8,110,85,80065,0,0,RAJASTHAN,Jaipur,VILLAGE,Bagru Khurd,Rural,847,495,352,591,230,361
8,110,85,80066,0,0,RAJASTHAN,Jaipur,VILLAGE,Teelawas,Rural,448,286,162,428,153,275
8,110,85,80067,0,0,RAJASTHAN,Jaipur,VILLAGE,Harchandpura @ Deoliya,Rural,934,576,358,556,184,372
8,110,85,80068,0,0,RAJASTHAN,Jaipur,VILLAGE,Rampurawas Deoliya,Rural,334,200,134,150,54,96
8,110,85,80069,0,0,RAJASTHAN,Jaipur,VILLAGE,Balmukundpura @ Nada,Rural,343,209,134,341,139,202
8,110,85,80070,0,0,RAJASTHAN,Jaipur,VILLAGE,Prithvisinghpura @ Naiwala,Rural,330,187,143,205,74,131
8,110,85,80071,0,0,RAJASTHAN,Jaipur,VILLAGE,Nangal Bar Goojran@Phagodiyawala,Rural,323,202,121,237,72,165
8,110,85,80072,0,0,RAJASTHAN,Jaipur,VILLAGE,Thikariya,Rural,1538,868,670,700,269,431
8,110,85,80073,0,0,RAJASTHAN,Jaipur,VILLAGE,Sarangpura,Rural,1053,631,422,534,192,342
8,110,85,80074,0,0,RAJASTHAN,Jaipur,VILLAGE,Ramchandpura,Rural,664,396,268,326,105,221
8,110,85,80075,0,0,RAJASTHAN,Jaipur,VILLAGE,Narsinghpura,Rural,666,397,269,363,115,248
8,110,85,80076,0,0,RAJASTHAN,Jaipur,VILLAGE,Mahapura,Rural,2544,1469,1075,1137,445,692
8,110,85,80077,0,0,RAJASTHAN,Jaipur,VILLAGE,Chatarpura@ Lalya Ka Bas,Rural,840,470,370,315,119,196
8,110,85,80078,0,0,RAJASTHAN,Jaipur,VILLAGE,Jhanyee,Rural,461,280,181,281,105,176
8,110,85,80079,0,0,RAJASTHAN,Jaipur,VILLAGE,Khatwara,Rural,1090,657,433,568,208,360
8,110,85,80080,0,0,RAJASTHAN,Jaipur,VILLAGE,Peepla Bharatsingh,Rural,1253,734,519,599,258,341
8,110,85,80081,0,0,RAJASTHAN,Jaipur,VILLAGE,Chak Harbanspura,Rural,113,64,49,40,15,25
8,110,85,80082,0,0,RAJASTHAN,Jaipur,VILLAGE,Mandau,Rural,912,527,385,558,233,325
8,110,85,80083,0,0,RAJASTHAN,Jaipur,VILLAGE,Harbanshpura,Rural,185,102,83,79,34,45
8,110,85,80084,0,0,RAJASTHAN,Jaipur,VILLAGE,Jaisinghpura,Rural,2437,1446,991,1561,607,954
8,110,85,80085,0,0,RAJASTHAN,Jaipur,VILLAGE,Narottampura,Rural,515,314,201,343,117,226
8,110,85,80086,0,0,RAJASTHAN,Jaipur,VILLAGE,Mohanpura,Rural,673,368,305,270,102,168
8,110,85,80087,0,0,RAJASTHAN,Jaipur,VILLAGE,Barhmohanpura,Rural,377,223,154,145,65,80
8,110,85,80088,0,0,RAJASTHAN,Jaipur,VILLAGE,Jagat Sharvanpura,Rural,280,152,128,117,52,65
8,110,85,80089,0,0,RAJASTHAN,Jaipur,VILLAGE,Muhana,Rural,4600,2726,1874,2817,1137,1680
8,110,85,80090,0,0,RAJASTHAN,Jaipur,VILLAGE,Hasampura Bas Neota,Rural,426,268,158,279,94,185
8,110,85,80091,0,0,RAJASTHAN,Jaipur,VILLAGE,Neota,Rural,2528,1516,1012,1773,691,1082
8,110,85,80092,0,0,RAJASTHAN,Jaipur,VILLAGE,Ramjipura Bas Neota,Rural,240,147,93,236,84,152
8,110,85,80093,0,0,RAJASTHAN,Jaipur,VILLAGE,Chak No 6 (Chak Kitavti),Rural,6,3,3,7,2,5
8,110,85,80094,0,0,RAJASTHAN,Jaipur,VILLAGE,Chak Basri,Rural,19,12,7,18,6,12
8,110,85,80095,0,0,RAJASTHAN,Jaipur,VILLAGE,Jaisinghpura Bas Neota,Rural,383,236,147,224,81,143
8,110,85,80096,0,0,RAJASTHAN,Jaipur,VILLAGE,Prempura,Rural,255,155,100,175,64,111
8,110,85,80097,0,0,RAJASTHAN,Jaipur,VILLAGE,Daulatpura,Rural,348,201,147,337,143,194
8,110,85,80098,0,0,RAJASTHAN,Jaipur,VILLAGE,Chatarpura,Rural,290,168,122,218,80,138
8,110,85,80099,0,0,RAJASTHAN,Jaipur,VILLAGE,Bhapura,Rural,645,426,219,714,288,426
8,110,85,80100,0,0,RAJASTHAN,Jaipur,VILLAGE,Chak No.7,Rural,104,67,37,97,36,61
8,110,85,80101,0,0,RAJASTHAN,Jaipur,VILLAGE,Chak Sherwali,Rural,5,1,4,6,3,3
8,110,85,80102,0,0,RAJASTHAN,Jaipur,VILLAGE,Girdharipura,Rural,5,3,2,2,1,1
8,110,85,80103,0,0,RAJASTHAN,Jaipur,VILLAGE,Kishanpura @ Khatipura,Rural,616,358,258,407,151,256
8,110,85,80104,0,0,RAJASTHAN,Jaipur,VILLAGE,Kapoorawala,Rural,1548,934,614,855,275,580
8,110,85,80105,0,0,RAJASTHAN,Jaipur,VILLAGE,Pawaliya,Rural,1315,744,571,1130,451,679
8,110,85,80106,0,0,RAJASTHAN,Jaipur,VILLAGE,Jaisinghpura @ Roopwas,Rural,471,289,182,477,181,296
8,110,85,80107,0,0,RAJASTHAN,Jaipur,VILLAGE,Manpura Teelawala,Rural,580,348,232,436,170,266
8,110,85,80108,0,0,RAJASTHAN,Jaipur,VILLAGE,Hargun Ki Nangal@Charanwala,Rural,820,514,306,581,227,354
8,110,85,80109,0,0,RAJASTHAN,Jaipur,VILLAGE,Kishorpura,Rural,433,256,177,182,64,118
8,110,85,80110,0,0,RAJASTHAN,Jaipur,VILLAGE,Balawala,Rural,851,511,340,437,158,279
8,110,85,80111,0,0,RAJASTHAN,Jaipur,VILLAGE,Shri Rampura,Rural,853,506,347,504,188,316
8,110,85,80112,0,0,RAJASTHAN,Jaipur,VILLAGE,Acharawala,Rural,447,267,180,288,93,195
8,110,85,80113,0,0,RAJASTHAN,Jaipur,VILLAGE,Jaisinghpura @ Tejawala,Rural,599,353,246,355,134,221
8,110,85,80114,0,0,RAJASTHAN,Jaipur,VILLAGE,Abhaipura,Rural,354,228,126,186,58,128
8,110,85,80115,0,0,RAJASTHAN,Jaipur,VILLAGE,Chak No.12,Rural,16,11,5,15,6,9
8,110,85,80116,0,0,RAJASTHAN,Jaipur,VILLAGE,Mahasinghpura @ Keshyawala,Rural,806,479,327,409,141,268
8,110,85,80117,0,0,RAJASTHAN,Jaipur,VILLAGE,Jagannathpura,Rural,365,232,133,298,121,177
8,110,85,80118,0,0,RAJASTHAN,Jaipur,VILLAGE,Ratalya,Rural,577,354,223,419,175,244
8,110,85,80119,0,0,RAJASTHAN,Jaipur,VILLAGE,Manohariya Wala,Rural,523,299,224,286,135,151
8,110,85,80120,0,0,RAJASTHAN,Jaipur,VILLAGE,Sitarampura,Rural,404,228,176,278,109,169
8,110,85,80121,0,0,RAJASTHAN,Jaipur,VILLAGE,Lakhana,Rural,270,173,97,193,62,131
8,110,85,80122,0,0,RAJASTHAN,Jaipur,VILLAGE,Jatawala,Rural,139,92,47,110,41,69
8,110,85,80123,0,0,RAJASTHAN,Jaipur,VILLAGE,Bhater,Rural,534,337,197,431,155,276
8,110,85,80124,0,0,RAJASTHAN,Jaipur,VILLAGE,Ramsinghpura,Rural,1261,743,518,786,284,502
8,110,85,80125,0,0,RAJASTHAN,Jaipur,VILLAGE,Watika,Rural,6465,3879,2586,4125,1632,2493
8,110,85,80126,0,0,RAJASTHAN,Jaipur,VILLAGE,Manpura @ Bhatawala,Rural,344,202,142,184,56,128
8,110,85,80127,0,0,RAJASTHAN,Jaipur,VILLAGE,Surajpura,Rural,579,366,213,434,149,285
8,110,85,80128,0,0,RAJASTHAN,Jaipur,VILLAGE,Ganwar Jatan,Rural,258,163,95,173,63,110
8,110,85,80129,0,0,RAJASTHAN,Jaipur,VILLAGE,Kheri Gokulpura,Rural,453,261,192,196,61,135
8,110,85,80130,0,0,RAJASTHAN,Jaipur,VILLAGE,Purshottampura @ Dadiya,Rural,698,428,270,507,186,321
8,110,85,80131,0,0,RAJASTHAN,Jaipur,VILLAGE,Badanpura,Rural,339,209,130,279,92,187
8,110,85,80132,0,0,RAJASTHAN,Jaipur,VILLAGE,Ganwar Brahmanan,Rural,709,403,306,411,161,250
8,110,85,80133,0,0,RAJASTHAN,Jaipur,VILLAGE,Baksawala,Rural,1058,681,377,992,397,595
8,110,85,80134,0,0,RAJASTHAN,Jaipur,VILLAGE,Asawala,Rural,1431,822,609,496,160,336
8,110,85,80135,0,0,RAJASTHAN,Jaipur,VILLAGE,Laxmipura @ Nataniwala,Rural,191,114,77,90,32,58
8,110,85,80136,0,0,RAJASTHAN,Jaipur,VILLAGE,Sukhdeopura @ Nataniwala,Rural,495,289,206,229,80,149
8,110,85,80137,0,0,RAJASTHAN,Jaipur,VILLAGE,Shri Ram Ki Nangal,Rural,3163,1995,1168,1901,716,1185
8,110,85,80138,0,0,RAJASTHAN,Jaipur,VILLAGE,Sukhdeopura @ Nohara,Rural,792,458,334,388,162,226
8,110,85,80139,0,0,RAJASTHAN,Jaipur,VILLAGE,Shyosinghpura @ Kallawala,Rural,759,452,307,444,171,273
8,110,85,80140,0,0,RAJASTHAN,Jaipur,VILLAGE,Barh Shyopur,Rural,323,193,130,187,71,116
8,110,85,80141,0,0,RAJASTHAN,Jaipur,VILLAGE,Dayalpura,Rural,514,320,194,307,123,184
8,110,85,80142,0,0,RAJASTHAN,Jaipur,VILLAGE,Chakwatika,Rural,88,53,35,72,30,42
8,110,85,80143,0,0,RAJASTHAN,Jaipur,VILLAGE,Mohanpura,Rural,772,487,285,571,206,365
8,110,85,80144,0,0,RAJASTHAN,Jaipur,VILLAGE,Chak Amjhar,Rural,76,43,33,88,38,50
8,110,85,80145,0,0,RAJASTHAN,Jaipur,VILLAGE,Khetapura,Rural,370,230,140,166,42,124
8,110,85,80146,0,0,RAJASTHAN,Jaipur,VILLAGE,Sanwant Ka Bas,Rural,175,105,70,108,36,72
8,110,85,80147,0,0,RAJASTHAN,Jaipur,VILLAGE,Jaisinghpura @ Buhariya,Rural,267,167,100,153,57,96
8,110,85,80148,0,0,RAJASTHAN,Jaipur,VILLAGE,Shyampura Buhariya,Rural,376,238,138,252,79,173
8,110,85,80149,0,0,RAJASTHAN,Jaipur,VILLAGE,Laxmipura,Rural,434,227,207,126,59,67
8,110,85,80150,0,0,RAJASTHAN,Jaipur,VILLAGE,Jaisinghpura @ Bas Beelwa,Rural,923,605,318,503,157,346
8,110,85,80151,0,0,RAJASTHAN,Jaipur,VILLAGE,Murlipura @ Mishra Ka Barh,Rural,1061,677,384,795,316,479
8,110,85,80152,0,0,RAJASTHAN,Jaipur,VILLAGE,Bari Ka Bas,Rural,694,437,257,637,253,384
8,110,85,80153,0,0,RAJASTHAN,Jaipur,VILLAGE,Khoosar,Rural,289,152,137,146,76,70
8,110,85,80154,0,0,RAJASTHAN,Jaipur,VILLAGE,Ramchandpura,Rural,1030,620,410,591,221,370
8,110,85,80155,0,0,RAJASTHAN,Jaipur,VILLAGE,Shri Kishanpura,Rural,757,457,300,619,277,342
8,110,85,80156,0,0,RAJASTHAN,Jaipur,VILLAGE,Jeerota,Rural,378,219,159,266,108,158
8,110,85,80157,0,0,RAJASTHAN,Jaipur,VILLAGE,Jaisinghpura Bas Jeerota,Rural,262,159,103,215,88,127
8,110,85,80158,0,0,RAJASTHAN,Jaipur,VILLAGE,Seesyawas,Rural,64,43,21,62,20,42
8,110,85,80159,0,0,RAJASTHAN,Jaipur,VILLAGE,Chatarpura,Rural,780,482,298,543,214,329
8,110,85,80160,0,0,RAJASTHAN,Jaipur,VILLAGE,Dantli,Rural,1625,1030,595,1095,402,693
8,110,85,80161,0,0,RAJASTHAN,Jaipur,VILLAGE,Siroli,Rural,1935,1193,742,1493,543,950
8,110,85,80162,0,0,RAJASTHAN,Jaipur,VILLAGE,Goner,Rural,4000,2382,1618,2049,803,1246
8,110,85,80163,0,0,RAJASTHAN,Jaipur,VILLAGE,Saligrampura,Rural,438,269,169,283,117,166
8,110,85,80164,0,0,RAJASTHAN,Jaipur,VILLAGE,Chak Saligrampura,Rural,62,36,26,48,20,28
8,110,85,80165,0,0,RAJASTHAN,Jaipur,VILLAGE,Vimalpura,Rural,397,236,161,503,207,296
8,110,85,80166,0,0,RAJASTHAN,Jaipur,VILLAGE,Vidhani,Rural,447,293,154,284,102,182
8,110,85,80167,0,0,RAJASTHAN,Jaipur,VILLAGE,Jaichandpura,Rural,3,3,0,5,2,3
8,110,85,80168,0,0,RAJASTHAN,Jaipur,VILLAGE,Rampura @ Kanwarpura,Rural,491,304,187,215,67,148
8,110,85,80169,0,0,RAJASTHAN,Jaipur,VILLAGE,Mathurawala,Rural,223,139,84,298,121,177
8,110,85,80170,0,0,RAJASTHAN,Jaipur,VILLAGE,Beelwa Kalan,Rural,2729,1656,1073,1674,641,1033
8,110,85,80171,0,0,RAJASTHAN,Jaipur,VILLAGE,Manpur Nagalya,Rural,404,256,148,292,104,188
8,110,85,80172,0,0,RAJASTHAN,Jaipur,VILLAGE,Ajairajpura,Rural,216,128,88,127,43,84
8,110,85,80173,0,0,RAJASTHAN,Jaipur,VILLAGE,Nanakpura @ Hema Ki Nangal,Rural,158,98,60,103,44,59
8,110,85,80174,0,0,RAJASTHAN,Jaipur,VILLAGE,Prahladpura,Rural,450,281,169,372,128,244
8,110,86,0,0,0,RAJASTHAN,Jaipur,CD BLOCK,Jhotwara,Total,86645,52174,34471,52861,20293,32568
8,110,86,0,0,0,RAJASTHAN,Jaipur,CD BLOCK,Jhotwara,Rural,81489,48911,32578,47227,17874,29353
8,110,86,0,0,0,RAJASTHAN,Jaipur,CD BLOCK,Jhotwara,Urban,5156,3263,1893,5634,2419,3215
8,110,86,80175,0,0,RAJASTHAN,Jaipur,VILLAGE,Manda Bhopawas,Rural,1130,692,438,894,365,529
8,110,86,80176,0,0,RAJASTHAN,Jaipur,VILLAGE,Charanwas,Rural,296,183,113,231,81,150
8,110,86,80177,0,0,RAJASTHAN,Jaipur,VILLAGE,Lalpura,Rural,1864,1159,705,1488,596,892
8,110,86,80178,0,0,RAJASTHAN,Jaipur,VILLAGE,Pachar,Rural,3350,2049,1301,2333,890,1443
8,110,86,80179,0,0,RAJASTHAN,Jaipur,VILLAGE,Ramla Ka Bas,Rural,311,204,107,269,99,170
8,110,86,80180,0,0,RAJASTHAN,Jaipur,VILLAGE,Kalwar,Rural,5335,3146,2189,3058,1162,1896
8,110,86,80181,0,0,RAJASTHAN,Jaipur,VILLAGE,Dharampura,Rural,339,196,143,156,62,94
8,110,86,80182,0,0,RAJASTHAN,Jaipur,VILLAGE,Gajadharpura,Rural,1070,633,437,734,288,446
8,110,86,80183,0,0,RAJASTHAN,Jaipur,VILLAGE,Chak Barh,Rural,95,61,34,50,17,33
8,110,86,80184,0,0,RAJASTHAN,Jaipur,VILLAGE,Sanchoti,Rural,788,477,311,523,199,324
8,110,86,80185,0,0,RAJASTHAN,Jaipur,VILLAGE,Chak Boytawala,Rural,203,111,92,112,48,64
8,110,86,80186,0,0,RAJASTHAN,Jaipur,VILLAGE,Sarna Chaur,Rural,889,516,373,546,196,350
8,110,86,80187,0,0,RAJASTHAN,Jaipur,VILLAGE,Bhoodharpura,Rural,392,233,159,274,95,179
8,110,86,80188,0,0,RAJASTHAN,Jaipur,VILLAGE,Chak Basri,Rural,419,250,169,285,109,176
8,110,86,80189,0,0,RAJASTHAN,Jaipur,VILLAGE,Chak Sarna Doongar,Rural,242,149,93,195,77,118
8,110,86,80190,0,0,RAJASTHAN,Jaipur,VILLAGE,Basri,Rural,132,73,59,75,25,50
8,110,86,80191,0,0,RAJASTHAN,Jaipur,VILLAGE,Chak Baori,Rural,96,51,45,83,26,57
8,110,86,80192,0,0,RAJASTHAN,Jaipur,VILLAGE,Baori,Rural,1132,676,456,661,229,432
8,110,86,80193,0,0,RAJASTHAN,Jaipur,VILLAGE,Sarna Doongar,Rural,1349,836,513,863,329,534
8,110,86,80194,0,0,RAJASTHAN,Jaipur,VILLAGE,Boytawala,Rural,5946,3582,2364,2721,1049,1672
8,110,86,80195,0,0,RAJASTHAN,Jaipur,VILLAGE,Niwaroo,Rural,7989,4649,3340,3756,1516,2240
8,110,86,80196,0,0,RAJASTHAN,Jaipur,VILLAGE,Mansharampura,Rural,1114,701,413,604,200,404
8,110,86,80197,0,0,RAJASTHAN,Jaipur,VILLAGE,Lalchandpura,Rural,1437,848,589,887,343,544
8,110,86,80198,0,0,RAJASTHAN,Jaipur,VILLAGE,Peethawas,Rural,1979,1169,810,1229,490,739
8,110,86,80199,0,0,RAJASTHAN,Jaipur,VILLAGE,Beer Hathod,Rural,785,477,308,456,165,291
8,110,86,80200,0,0,RAJASTHAN,Jaipur,VILLAGE,Hathod,Rural,4326,2512,1814,1873,720,1153
8,110,86,80201,0,0,RAJASTHAN,Jaipur,VILLAGE,Nari Ka Bas,Rural,570,331,239,289,118,171
8,110,86,80202,0,0,RAJASTHAN,Jaipur,VILLAGE,Champapura,Rural,423,246,177,289,98,191
8,110,86,80203,0,0,RAJASTHAN,Jaipur,VILLAGE,Manchwa,Rural,1502,910,592,951,368,583
8,110,86,80204,0,0,RAJASTHAN,Jaipur,VILLAGE,Pindolai,Rural,1055,635,420,628,233,395
8,110,86,80205,0,0,RAJASTHAN,Jaipur,VILLAGE,Sabrampura,Rural,669,397,272,435,179,256
8,110,86,80206,0,0,RAJASTHAN,Jaipur,VILLAGE,Bhambhori,Rural,2564,1545,1019,1310,471,839
8,110,86,80207,0,0,RAJASTHAN,Jaipur,VILLAGE,Sundariyawas,Rural,700,420,280,477,205,272
8,110,86,80208,0,0,RAJASTHAN,Jaipur,VILLAGE,Durjaniyawas,Rural,530,307,223,294,100,194
8,110,86,80209,0,0,RAJASTHAN,Jaipur,VILLAGE,Sarang Ka Bas,Rural,1025,574,451,446,187,259
8,110,86,80210,0,0,RAJASTHAN,Jaipur,VILLAGE,Kanwar Ka Bas,Rural,760,453,307,415,150,265
8,110,86,80211,0,0,RAJASTHAN,Jaipur,VILLAGE,Kapariyawas,Rural,858,552,306,634,215,419
8,110,86,80212,0,0,RAJASTHAN,Jaipur,VILLAGE,Gurliya,Rural,256,170,86,146,42,104
8,110,86,80213,0,0,RAJASTHAN,Jaipur,VILLAGE,Shyosinghpura @ Shyopura,Rural,888,554,334,527,174,353
8,110,86,80214,0,0,RAJASTHAN,Jaipur,VILLAGE,Baseri,Rural,1202,720,482,641,208,433
8,110,86,80215,0,0,RAJASTHAN,Jaipur,VILLAGE,Begas,Rural,3190,1894,1296,1959,723,1236
8,110,86,80216,0,0,RAJASTHAN,Jaipur,VILLAGE,Chak Begas,Rural,211,130,81,157,68,89
8,110,86,80217,0,0,RAJASTHAN,Jaipur,VILLAGE,Ramsingh Pura,Rural,879,554,325,638,231,407
8,110,86,80218,0,0,RAJASTHAN,Jaipur,VILLAGE,Achanchukya,Rural,247,138,109,169,75,94
8,110,86,80219,0,0,RAJASTHAN,Jaipur,VILLAGE,Mansinghpura,Rural,458,252,206,196,71,125
8,110,86,80220,0,0,RAJASTHAN,Jaipur,VILLAGE,Fatehpura,Rural,886,547,339,492,161,331
8,110,86,80221,0,0,RAJASTHAN,Jaipur,VILLAGE,Barh Fatehpura,Rural,235,129,106,69,23,46
8,110,86,80222,0,0,RAJASTHAN,Jaipur,VILLAGE,Himmatpura,Rural,555,351,204,352,120,232
8,110,86,80223,0,0,RAJASTHAN,Jaipur,VILLAGE,Sitapura @ Ramoli,Rural,122,80,42,71,25,46
8,110,86,80224,0,0,RAJASTHAN,Jaipur,VILLAGE,Jaisinghpura Kankroda,Rural,404,260,144,317,129,188
8,110,86,80225,0,0,RAJASTHAN,Jaipur,VILLAGE,Kishorpura @ Kankroda,Rural,279,164,115,225,98,127
8,110,86,80226,0,0,RAJASTHAN,Jaipur,VILLAGE,Laxmipura @ Chak Mauja,Rural,234,142,92,100,39,61
8,110,86,80227,0,0,RAJASTHAN,Jaipur,VILLAGE,Mundiya Purohitan,Rural,652,396,256,399,161,238
8,110,86,80228,0,0,RAJASTHAN,Jaipur,VILLAGE,Chak Ramsar,Rural,593,367,226,362,130,232
8,110,86,80229,0,0,RAJASTHAN,Jaipur,VILLAGE,Kanarpura @ Khanga Ki Dhani,Rural,509,299,210,257,75,182
8,110,86,80230,0,0,RAJASTHAN,Jaipur,VILLAGE,Keshyawala,Rural,420,252,168,209,60,149
8,110,86,80231,0,0,RAJASTHAN,Jaipur,VILLAGE,Shrirampura @ Tewariwala,Rural,690,395,295,270,93,177
8,110,86,80232,0,0,RAJASTHAN,Jaipur,VILLAGE,Dhankya,Rural,1735,1074,661,983,334,649
8,110,86,80233,0,0,RAJASTHAN,Jaipur,VILLAGE,Nandgaon Barsana,Rural,570,353,217,383,137,246
8,110,86,80234,0,0,RAJASTHAN,Jaipur,VILLAGE,Mundiya Ramsar,Rural,1216,732,484,702,285,417
8,110,86,80235,0,0,RAJASTHAN,Jaipur,VILLAGE,Neemera,Rural,1855,1121,734,972,331,641
8,110,86,80236,0,0,RAJASTHAN,Jaipur,VILLAGE,Natlalpura,Rural,244,162,82,202,74,128
8,110,86,80237,0,0,RAJASTHAN,Jaipur,VILLAGE,Bichpari,Rural,451,276,175,289,104,185
8,110,86,80238,0,0,RAJASTHAN,Jaipur,VILLAGE,Jaibhawanipura,Rural,179,103,76,90,36,54
8,110,86,80239,0,0,RAJASTHAN,Jaipur,VILLAGE,Govindpura @ Jaichandpura,Rural,265,160,105,140,52,88
8,110,86,80240,0,0,RAJASTHAN,Jaipur,VILLAGE,Balloopura,Rural,433,274,159,295,105,190
8,110,86,80241,0,0,RAJASTHAN,Jaipur,VILLAGE,Sumel,Rural,1820,1178,642,1468,560,908
8,110,86,80242,0,0,RAJASTHAN,Jaipur,VILLAGE,Roopa Ki Nangal,Rural,426,263,163,480,198,282
8,110,86,80243,0,0,RAJASTHAN,Jaipur,VILLAGE,Malpura Doongar,Rural,94,59,35,72,32,40
8,110,86,80244,0,0,RAJASTHAN,Jaipur,VILLAGE,Beermalpura @ Mukandpura,Rural,69,47,22,175,78,97
8,110,86,80245,0,0,RAJASTHAN,Jaipur,VILLAGE,Malpura Chaur,Rural,220,137,83,234,96,138
8,110,86,80246,0,0,RAJASTHAN,Jaipur,VILLAGE,Vijaypura,Rural,5338,3175,2163,2662,1046,1616
8,110,86,80247,0,0,RAJASTHAN,Jaipur,TOWN,Bagrana (CT),Urban,5156,3263,1893,5634,2419,3215
8,110,87,0,0,0,RAJASTHAN,Jaipur,CD BLOCK,Amber,Total,192733,121394,71339,135959,49816,86143
8,110,87,0,0,0,RAJASTHAN,Jaipur,CD BLOCK,Amber,Rural,186964,117820,69144,132666,48531,84135
8,110,87,0,0,0,RAJASTHAN,Jaipur,CD BLOCK,Amber,Urban,5769,3574,2195,3293,1285,2008
8,110,87,80248,0,0,RAJASTHAN,Jaipur,VILLAGE,Raithal,Rural,2372,1498,874,1662,610,1052
8,110,87,80249,0,0,RAJASTHAN,Jaipur,VILLAGE,Ballupura,Rural,315,197,118,190,66,124
8,110,87,80250,0,0,RAJASTHAN,Jaipur,VILLAGE,Chak Jaisinghpura,Rural,38,24,14,24,12,12
8,110,87,80251,0,0,RAJASTHAN,Jaipur,VILLAGE,Tadawas,Rural,1398,870,528,908,347,561
8,110,87,80252,0,0,RAJASTHAN,Jaipur,VILLAGE,Pratappura Kalan,Rural,765,493,272,467,146,321
8,110,87,80253,0,0,RAJASTHAN,Jaipur,VILLAGE,Pratappura Khurd,Rural,341,221,120,272,102,170
8,110,87,80254,0,0,RAJASTHAN,Jaipur,VILLAGE,Khapariya,Rural,851,575,276,655,237,418
8,110,87,80255,0,0,RAJASTHAN,Jaipur,VILLAGE,Durga Ka Bas,Rural,687,465,222,516,203,313
8,110,87,80256,0,0,RAJASTHAN,Jaipur,VILLAGE,Mundiya,Rural,555,368,187,430,132,298
8,110,87,80257,0,0,RAJASTHAN,Jaipur,VILLAGE,Chak Mundiya,Rural,46,29,17,21,6,15
8,110,87,80258,0,0,RAJASTHAN,Jaipur,VILLAGE,Disan,Rural,412,239,173,286,97,189
8,110,87,80259,0,0,RAJASTHAN,Jaipur,VILLAGE,Sahib Rampura,Rural,529,314,215,302,115,187
8,110,87,80260,0,0,RAJASTHAN,Jaipur,VILLAGE,Kalyanpura,Rural,417,272,145,246,75,171
8,110,87,80261,0,0,RAJASTHAN,Jaipur,VILLAGE,Patti Sitarampura,Rural,238,147,91,161,61,100
8,110,87,80262,0,0,RAJASTHAN,Jaipur,VILLAGE,Anoppura,Rural,1201,717,484,787,260,527
8,110,87,80263,0,0,RAJASTHAN,Jaipur,VILLAGE,Daula Ka Bas,Rural,405,244,161,245,88,157
8,110,87,80264,0,0,RAJASTHAN,Jaipur,VILLAGE,Khatiyon Ka Bas,Rural,362,219,143,195,64,131
8,110,87,80265,0,0,RAJASTHAN,Jaipur,VILLAGE,Pragpura,Rural,405,279,126,457,186,271
8,110,87,80266,0,0,RAJASTHAN,Jaipur,VILLAGE,Bheelpura,Rural,1182,776,406,803,266,537
8,110,87,80267,0,0,RAJASTHAN,Jaipur,VILLAGE,Radha Kishanpura @ Pokharsa Ka Bas,Rural,581,359,222,334,121,213
8,110,87,80268,0,0,RAJASTHAN,Jaipur,VILLAGE,Ramgatta @ Harwanshpura,Rural,324,190,134,144,48,96
8,110,87,80269,0,0,RAJASTHAN,Jaipur,VILLAGE,Nara,Rural,246,153,93,150,59,91
8,110,87,80270,0,0,RAJASTHAN,Jaipur,VILLAGE,Biharipura,Rural,1543,976,567,1013,333,680
8,110,87,80271,0,0,RAJASTHAN,Jaipur,VILLAGE,Sirsali,Rural,1871,1123,748,1080,389,691
8,110,87,80272,0,0,RAJASTHAN,Jaipur,VILLAGE,Gudha Surjan,Rural,1491,914,577,1046,363,683
8,110,87,80273,0,0,RAJASTHAN,Jaipur,VILLAGE,Mohanpura,Rural,518,337,181,309,100,209
8,110,87,80274,0,0,RAJASTHAN,Jaipur,VILLAGE,Mukandpura,Rural,820,522,298,557,187,370
8,110,87,80275,0,0,RAJASTHAN,Jaipur,VILLAGE,Raghunathpura,Rural,783,475,308,541,178,363
8,110,87,80276,0,0,RAJASTHAN,Jaipur,VILLAGE,Barna,Rural,966,608,358,552,190,362
8,110,87,80277,0,0,RAJASTHAN,Jaipur,VILLAGE,Jaisinghpura Shekhawatan,Rural,622,381,241,378,135,243
8,110,87,80278,0,0,RAJASTHAN,Jaipur,VILLAGE,Barsinghpura,Rural,298,184,114,223,77,146
8,110,87,80279,0,0,RAJASTHAN,Jaipur,VILLAGE,Vijaipura,Rural,709,452,257,506,174,332
8,110,87,80280,0,0,RAJASTHAN,Jaipur,VILLAGE,Punana,Rural,1508,942,566,1033,367,666
8,110,87,80281,0,0,RAJASTHAN,Jaipur,VILLAGE,Bishanpura,Rural,461,276,185,317,113,204
8,110,87,80282,0,0,RAJASTHAN,Jaipur,VILLAGE,Radhapura,Rural,550,352,198,361,111,250
8,110,87,80283,0,0,RAJASTHAN,Jaipur,VILLAGE,Radhakishanpura,Rural,1040,674,366,621,203,418
8,110,87,80284,0,0,RAJASTHAN,Jaipur,VILLAGE,Sirsi,Rural,830,531,299,646,230,416
8,110,87,80285,0,0,RAJASTHAN,Jaipur,VILLAGE,Yadav Khera,Rural,499,306,193,304,107,197
8,110,87,80286,0,0,RAJASTHAN,Jaipur,VILLAGE,Nangal Ladi,Rural,1687,1077,610,1267,449,818
8,110,87,80287,0,0,RAJASTHAN,Jaipur,VILLAGE,Bichpari,Rural,614,389,225,408,152,256
8,110,87,80288,0,0,RAJASTHAN,Jaipur,VILLAGE,Chandrapura Jatan,Rural,505,329,176,375,145,230
8,110,87,80289,0,0,RAJASTHAN,Jaipur,VILLAGE,Bugalia,Rural,884,575,309,679,248,431
8,110,87,80290,0,0,RAJASTHAN,Jaipur,VILLAGE,Sherawatpura,Rural,1199,765,434,936,315,621
8,110,87,80291,0,0,RAJASTHAN,Jaipur,VILLAGE,Mundota,Rural,3226,2059,1167,2541,953,1588
8,110,87,80292,0,0,RAJASTHAN,Jaipur,VILLAGE,Jiloi,Rural,463,298,165,419,159,260
8,110,87,80293,0,0,RAJASTHAN,Jaipur,VILLAGE,Maheshwas Khurd,Rural,435,282,153,465,164,301
8,110,87,80294,0,0,RAJASTHAN,Jaipur,VILLAGE,Maheshwas Kalan,Rural,1548,910,638,1031,410,621
8,110,87,80295,0,0,RAJASTHAN,Jaipur,VILLAGE,Jaitpura,Rural,276,166,110,279,115,164
8,110,87,80296,0,0,RAJASTHAN,Jaipur,VILLAGE,Chak Rojda,Rural,487,291,196,296,114,182
8,110,87,80297,0,0,RAJASTHAN,Jaipur,VILLAGE,Chak Jaitpura,Rural,122,76,46,62,19,43
8,110,87,80298,0,0,RAJASTHAN,Jaipur,VILLAGE,Naradpura,Rural,634,399,235,463,173,290
8,110,87,80299,0,0,RAJASTHAN,Jaipur,VILLAGE,Dadar Baori,Rural,501,300,201,282,101,181
8,110,87,80300,0,0,RAJASTHAN,Jaipur,VILLAGE,Bas Baori,Rural,87,50,37,58,26,32
8,110,87,80301,0,0,RAJASTHAN,Jaipur,VILLAGE,Sudarshanpura,Rural,686,405,281,431,156,275
8,110,87,80302,0,0,RAJASTHAN,Jaipur,VILLAGE,Yadavkhera,Rural,337,210,127,219,78,141
8,110,87,80303,0,0,RAJASTHAN,Jaipur,VILLAGE,Khannipura,Rural,260,160,100,181,64,117
8,110,87,80304,0,0,RAJASTHAN,Jaipur,VILLAGE,Shripura,Rural,825,526,299,613,218,395
8,110,87,80305,0,0,RAJASTHAN,Jaipur,VILLAGE,Lalpura,Rural,264,163,101,168,67,101
8,110,87,80306,0,0,RAJASTHAN,Jaipur,VILLAGE,Lalgarh,Rural,469,282,187,272,102,170
8,110,87,80307,0,0,RAJASTHAN,Jaipur,VILLAGE,Jalsoo,Rural,979,594,385,584,199,385
8,110,87,80308,0,0,RAJASTHAN,Jaipur,VILLAGE,Deogudha,Rural,1617,1011,606,1057,381,676
8,110,87,80309,0,0,RAJASTHAN,Jaipur,VILLAGE,Mori,Rural,885,558,327,681,278,403
8,110,87,80310,0,0,RAJASTHAN,Jaipur,VILLAGE,Atalbiharipura,Rural,445,270,175,288,95,193
8,110,87,80311,0,0,RAJASTHAN,Jaipur,VILLAGE,Kanwarpura,Rural,212,130,82,109,34,75
8,110,87,80312,0,0,RAJASTHAN,Jaipur,VILLAGE,Barh Jahota,Rural,85,48,37,77,33,44
8,110,87,80313,0,0,RAJASTHAN,Jaipur,VILLAGE,Mukandpura,Rural,245,161,84,188,61,127
8,110,87,80314,0,0,RAJASTHAN,Jaipur,VILLAGE,Mohanbari,Rural,541,335,206,474,179,295
8,110,87,80315,0,0,RAJASTHAN,Jaipur,VILLAGE,Dwarkapura,Rural,174,106,68,115,37,78
8,110,87,80316,0,0,RAJASTHAN,Jaipur,VILLAGE,Jahota,Rural,3888,2307,1581,2083,742,1341
8,110,87,80317,0,0,RAJASTHAN,Jaipur,VILLAGE,Bhoorawali,Rural,1058,691,367,686,221,465
8,110,87,80318,0,0,RAJASTHAN,Jaipur,VILLAGE,Chimanpura,Rural,868,513,355,412,162,250
8,110,87,80319,0,0,RAJASTHAN,Jaipur,VILLAGE,Bhatton Ki Gali,Rural,1503,880,623,727,271,456
8,110,87,80320,0,0,RAJASTHAN,Jaipur,VILLAGE,Jairampura,Rural,3128,1929,1199,2188,838,1350
8,110,87,80321,0,0,RAJASTHAN,Jaipur,VILLAGE,Govindpura,Rural,1412,855,557,1068,428,640
8,110,87,80322,0,0,RAJASTHAN,Jaipur,VILLAGE,Dattawata,Rural,293,187,106,187,56,131
8,110,87,80323,0,0,RAJASTHAN,Jaipur,VILLAGE,Chatarpura,Rural,1281,719,562,923,317,606
8,110,87,80324,0,0,RAJASTHAN,Jaipur,VILLAGE,Achhojai,Rural,980,634,346,946,389,557
8,110,87,80325,0,0,RAJASTHAN,Jaipur,VILLAGE,Harchandpura,Rural,288,172,116,221,84,137
8,110,87,80326,0,0,RAJASTHAN,Jaipur,VILLAGE,Rojda,Rural,1899,1142,757,1285,477,808
8,110,87,80327,0,0,RAJASTHAN,Jaipur,VILLAGE,Sindolai,Rural,522,332,190,473,182,291
8,110,87,80328,0,0,RAJASTHAN,Jaipur,VILLAGE,Sardarpura,Rural,899,553,346,637,251,386
8,110,87,80329,0,0,RAJASTHAN,Jaipur,VILLAGE,Dalpura,Rural,398,249,149,302,115,187
8,110,87,80330,0,0,RAJASTHAN,Jaipur,VILLAGE,Kishanpura,Rural,606,380,226,429,153,276
8,110,87,80331,0,0,RAJASTHAN,Jaipur,VILLAGE,Hardattpura,Rural,499,316,183,287,86,201
8,110,87,80332,0,0,RAJASTHAN,Jaipur,VILLAGE,Shubhrampura,Rural,532,314,218,408,168,240
8,110,87,80333,0,0,RAJASTHAN,Jaipur,VILLAGE,Khorabeesal,Rural,3568,2145,1423,2034,733,1301
8,110,87,80334,0,0,RAJASTHAN,Jaipur,VILLAGE,Benarwith Daulatpura,Rural,2984,1871,1113,1844,708,1136
8,110,87,80335,0,0,RAJASTHAN,Jaipur,VILLAGE,Nangal Siras,Rural,954,612,342,844,340,504
8,110,87,80336,0,0,RAJASTHAN,Jaipur,VILLAGE,Maheshpura Rawan,Rural,568,349,219,374,132,242
8,110,87,80337,0,0,RAJASTHAN,Jaipur,VILLAGE,Akeda Chaud,Rural,1313,766,547,566,211,355
8,110,87,80338,0,0,RAJASTHAN,Jaipur,VILLAGE,Rampura,Rural,2578,1535,1043,1346,495,851
8,110,87,80339,0,0,RAJASTHAN,Jaipur,VILLAGE,Tatiyawas,Rural,1251,733,518,799,311,488
8,110,87,80340,0,0,RAJASTHAN,Jaipur,VILLAGE,Dabri,Rural,1781,1112,669,981,335,646
8,110,87,80341,0,0,RAJASTHAN,Jaipur,VILLAGE,Boodthal,Rural,1868,1113,755,1153,440,713
8,110,87,80342,0,0,RAJASTHAN,Jaipur,VILLAGE,Degdas,Rural,306,208,98,200,71,129
8,110,87,80343,0,0,RAJASTHAN,Jaipur,VILLAGE,Chak Degdas,Rural,139,86,53,122,48,74
8,110,87,80344,0,0,RAJASTHAN,Jaipur,VILLAGE,Risani,Rural,1253,795,458,883,304,579
8,110,87,80345,0,0,RAJASTHAN,Jaipur,VILLAGE,Chonp,Rural,3522,2178,1344,2483,895,1588
8,110,87,80346,0,0,RAJASTHAN,Jaipur,VILLAGE,Israwala,Rural,956,596,360,771,286,485
8,110,87,80347,0,0,RAJASTHAN,Jaipur,VILLAGE,Bilonchi,Rural,2393,1530,863,1728,617,1111
8,110,87,80348,0,0,RAJASTHAN,Jaipur,VILLAGE,Shri Govindpura,Rural,602,363,239,378,132,246
8,110,87,80349,0,0,RAJASTHAN,Jaipur,VILLAGE,Ghatwada,Rural,1729,1136,593,1427,522,905
8,110,87,80350,0,0,RAJASTHAN,Jaipur,VILLAGE,Sar,Rural,327,230,97,327,137,190
8,110,87,80351,0,0,RAJASTHAN,Jaipur,VILLAGE,Kalighati,Rural,385,292,93,423,138,285
8,110,87,80352,0,0,RAJASTHAN,Jaipur,VILLAGE,Jaitpur Kheenchee,Rural,1035,683,352,896,332,564
8,110,87,80353,0,0,RAJASTHAN,Jaipur,VILLAGE,Sangawala,Rural,582,392,190,424,147,277
8,110,87,80354,0,0,RAJASTHAN,Jaipur,VILLAGE,Ladana,Rural,27,21,6,25,13,12
8,110,87,80355,0,0,RAJASTHAN,Jaipur,VILLAGE,Kiratpura,Rural,121,86,35,129,46,83
8,110,87,80356,0,0,RAJASTHAN,Jaipur,VILLAGE,Kant,Rural,603,416,187,582,222,360
8,110,87,80357,0,0,RAJASTHAN,Jaipur,VILLAGE,Puth Ka Bas @ Chawa Ka Bas,Rural,583,406,177,685,258,427
8,110,87,80358,0,0,RAJASTHAN,Jaipur,VILLAGE,Manpura Mancheri,Rural,5222,3389,1833,3945,1420,2525
8,110,87,80359,0,0,RAJASTHAN,Jaipur,VILLAGE,Roondal,Rural,4297,2663,1634,2760,1000,1760
8,110,87,80360,0,0,RAJASTHAN,Jaipur,VILLAGE,Nakawala,Rural,290,198,92,264,101,163
8,110,87,80361,0,0,RAJASTHAN,Jaipur,VILLAGE,Sirohi,Rural,1075,707,368,905,315,590
8,110,87,80362,0,0,RAJASTHAN,Jaipur,VILLAGE,Beelpura,Rural,964,559,405,409,159,250
8,110,87,80363,0,0,RAJASTHAN,Jaipur,VILLAGE,Chittanukalan,Rural,1725,1148,577,1505,534,971
8,110,87,80364,0,0,RAJASTHAN,Jaipur,VILLAGE,Sundarpura,Rural,513,347,166,402,135,267
8,110,87,80365,0,0,RAJASTHAN,Jaipur,VILLAGE,Lamyamewal,Rural,349,240,109,352,139,213
8,110,87,80366,0,0,RAJASTHAN,Jaipur,VILLAGE,Sunder Ka Bas,Rural,655,439,216,663,253,410
8,110,87,80367,0,0,RAJASTHAN,Jaipur,VILLAGE,Chak Manoharpur,Rural,942,606,336,823,318,505
8,110,87,80368,0,0,RAJASTHAN,Jaipur,VILLAGE,Deo Ka Harwara,Rural,1290,860,430,1191,476,715
8,110,87,80369,0,0,RAJASTHAN,Jaipur,VILLAGE,Lakher,Rural,2231,1427,804,1488,534,954
8,110,87,80370,0,0,RAJASTHAN,Jaipur,VILLAGE,Bhuranpura @Nestiwas,Rural,607,387,220,576,219,357
8,110,87,80371,0,0,RAJASTHAN,Jaipur,VILLAGE,Arniya,Rural,1261,853,408,1048,384,664
8,110,87,80372,0,0,RAJASTHAN,Jaipur,VILLAGE,Kanwarpura,Rural,1278,832,446,1105,428,677
8,110,87,80373,0,0,RAJASTHAN,Jaipur,VILLAGE,Harchandpura @Kankarwala,Rural,822,518,304,579,231,348
8,110,87,80374,0,0,RAJASTHAN,Jaipur,VILLAGE,Peelwa,Rural,952,643,309,983,375,608
8,110,87,80375,0,0,RAJASTHAN,Jaipur,VILLAGE,Salarwas,Rural,439,272,167,364,140,224
8,110,87,80376,0,0,RAJASTHAN,Jaipur,VILLAGE,Chandwaji,Rural,1292,761,531,786,318,468
8,110,87,80377,0,0,RAJASTHAN,Jaipur,VILLAGE,Jaisingh Nagar,Rural,162,102,60,112,43,69
8,110,87,80378,0,0,RAJASTHAN,Jaipur,VILLAGE,Rajpurwas Chandwaji,Rural,212,153,59,229,79,150
8,110,87,80379,0,0,RAJASTHAN,Jaipur,VILLAGE,Chandawas,Rural,898,638,260,1582,654,928
8,110,87,80380,0,0,RAJASTHAN,Jaipur,VILLAGE,Shyampura,Rural,631,407,224,442,155,287
8,110,87,80381,0,0,RAJASTHAN,Jaipur,VILLAGE,Kushalpura,Rural,438,285,153,512,226,286
8,110,87,80382,0,0,RAJASTHAN,Jaipur,VILLAGE,Jugalpura,Rural,501,319,182,468,177,291
8,110,87,80383,0,0,RAJASTHAN,Jaipur,VILLAGE,Chak Jaisinghnagar,Rural,0,0,0,0,0,0
8,110,87,80384,0,0,RAJASTHAN,Jaipur,VILLAGE,Rampura @ Banyawala,Rural,392,233,159,315,110,205
8,110,87,80385,0,0,RAJASTHAN,Jaipur,VILLAGE,Syari,Rural,857,529,328,577,219,358
8,110,87,80386,0,0,RAJASTHAN,Jaipur,VILLAGE,Kalwad Kalan,Rural,1177,802,375,1095,390,705
8,110,87,80387,0,0,RAJASTHAN,Jaipur,VILLAGE,Achrol,Rural,8643,5471,3172,6434,2390,4044
8,110,87,80388,0,0,RAJASTHAN,Jaipur,VILLAGE,Ani,Rural,1241,777,464,745,253,492
8,110,87,80389,0,0,RAJASTHAN,Jaipur,VILLAGE,Dheengpur,Rural,395,228,167,194,66,128
8,110,87,80390,0,0,RAJASTHAN,Jaipur,VILLAGE,Labana,Rural,1925,1219,706,1190,402,788
8,110,87,80391,0,0,RAJASTHAN,Jaipur,VILLAGE,Gunawata,Rural,1475,1028,447,1114,374,740
8,110,87,80392,0,0,RAJASTHAN,Jaipur,VILLAGE,Chhaprari,Rural,513,322,191,482,166,316
8,110,87,80393,0,0,RAJASTHAN,Jaipur,VILLAGE,Seengwana,Rural,446,314,132,536,198,338
8,110,87,80394,0,0,RAJASTHAN,Jaipur,VILLAGE,Pokharawala @ Anandpura,Rural,578,395,183,323,97,226
8,110,87,80395,0,0,RAJASTHAN,Jaipur,VILLAGE,Chak Pokharawala,Rural,53,33,20,25,10,15
8,110,87,80396,0,0,RAJASTHAN,Jaipur,VILLAGE,Bheevpura,Rural,888,556,332,770,306,464
8,110,87,80397,0,0,RAJASTHAN,Jaipur,VILLAGE,Bagwada,Rural,3013,1881,1132,1853,627,1226
8,110,87,80398,0,0,RAJASTHAN,Jaipur,VILLAGE,Kacherawala @ Chokhlawas,Rural,414,274,140,480,193,287
8,110,87,80399,0,0,RAJASTHAN,Jaipur,VILLAGE,Harwar,Rural,557,356,201,478,182,296
8,110,87,80400,0,0,RAJASTHAN,Jaipur,VILLAGE,Dhand,Rural,1411,889,522,828,229,599
8,110,87,80401,0,0,RAJASTHAN,Jaipur,VILLAGE,Rajpur Khanaya,Rural,326,207,119,218,78,140
8,110,87,80402,0,0,RAJASTHAN,Jaipur,VILLAGE,Nangal Turkan,Rural,242,174,68,228,78,150
8,110,87,80403,0,0,RAJASTHAN,Jaipur,VILLAGE,Kankrel,Rural,706,452,254,662,225,437
8,110,87,80404,0,0,RAJASTHAN,Jaipur,VILLAGE,Chak Kotiya,Rural,312,189,123,189,65,124
8,110,87,80405,0,0,RAJASTHAN,Jaipur,VILLAGE,Khora Meena,Rural,1637,1062,575,1069,355,714
8,110,87,80406,0,0,RAJASTHAN,Jaipur,VILLAGE,Kookas,Rural,2375,1477,898,1567,574,993
8,110,87,80407,0,0,RAJASTHAN,Jaipur,VILLAGE,Kotra,Rural,662,422,240,514,183,331
8,110,87,80408,0,0,RAJASTHAN,Jaipur,VILLAGE,Daulatpura,Rural,2049,1319,730,1679,636,1043
8,110,87,80409,0,0,RAJASTHAN,Jaipur,VILLAGE,Kherwari,Rural,613,408,205,517,184,333
8,110,87,80410,0,0,RAJASTHAN,Jaipur,VILLAGE,Rampura,Rural,630,378,252,446,157,289
8,110,87,80411,0,0,RAJASTHAN,Jaipur,VILLAGE,Chirara,Rural,550,360,190,485,185,300
8,110,87,80412,0,0,RAJASTHAN,Jaipur,VILLAGE,Khora Shyamdas,Rural,2338,1461,877,1579,614,965
8,110,87,80413,0,0,RAJASTHAN,Jaipur,VILLAGE,Badanpura,Rural,621,387,234,454,167,287
8,110,87,80414,0,0,RAJASTHAN,Jaipur,VILLAGE,Chetawala,Rural,1030,637,393,755,306,449
8,110,87,80415,0,0,RAJASTHAN,Jaipur,VILLAGE,Chhanwar Ka Bas,Rural,337,209,128,185,59,126
8,110,87,80416,0,0,RAJASTHAN,Jaipur,VILLAGE,Raja Rampura,Rural,611,369,242,473,187,286
8,110,87,80417,0,0,RAJASTHAN,Jaipur,VILLAGE,Mothoo Ka Bas,Rural,953,606,347,683,287,396
8,110,87,80418,0,0,RAJASTHAN,Jaipur,VILLAGE,Rajawas,Rural,1447,854,593,1006,387,619
8,110,87,80419,0,0,RAJASTHAN,Jaipur,VILLAGE,Nangal Purohit,Rural,1973,1204,769,1325,472,853
8,110,87,80420,0,0,RAJASTHAN,Jaipur,VILLAGE,Chak Nangal,Rural,75,46,29,43,13,30
8,110,87,80421,0,0,RAJASTHAN,Jaipur,VILLAGE,Ramlyawala,Rural,549,335,214,404,150,254
8,110,87,80422,0,0,RAJASTHAN,Jaipur,VILLAGE,Deeppura,Rural,480,302,178,322,125,197
8,110,87,80423,0,0,RAJASTHAN,Jaipur,VILLAGE,Jagnnathpura,Rural,615,380,235,568,211,357
8,110,87,80424,0,0,RAJASTHAN,Jaipur,VILLAGE,Udaipuriya,Rural,1128,722,406,1154,490,664
8,110,87,80425,0,0,RAJASTHAN,Jaipur,VILLAGE,Looniyawas,Rural,896,566,330,528,177,351
8,110,87,80426,0,0,RAJASTHAN,Jaipur,VILLAGE,Hanumanpura With Chak,Rural,334,221,113,224,67,157
8,110,87,80427,0,0,RAJASTHAN,Jaipur,VILLAGE,Sewapura,Rural,834,534,300,588,229,359
8,110,87,80428,0,0,RAJASTHAN,Jaipur,VILLAGE,Bishangarh,Rural,425,268,157,310,122,188
8,110,87,80429,0,0,RAJASTHAN,Jaipur,VILLAGE,Akhepura,Rural,469,286,183,255,95,160
8,110,87,80430,0,0,RAJASTHAN,Jaipur,VILLAGE,Laxminarayanpura,Rural,1161,697,464,629,222,407
8,110,87,80431,0,0,RAJASTHAN,Jaipur,VILLAGE,Jaisalya,Rural,369,236,133,295,117,178
8,110,87,80432,0,0,RAJASTHAN,Jaipur,VILLAGE,Maila Bagh,Rural,0,0,0,0,0,0
8,110,87,80433,0,0,RAJASTHAN,Jaipur,VILLAGE,Shisiyawas,Rural,746,502,244,583,198,385
8,110,87,80434,0,0,RAJASTHAN,Jaipur,VILLAGE,Baragaon Jarkhya,Rural,463,287,176,356,128,228
8,110,87,80435,0,0,RAJASTHAN,Jaipur,VILLAGE,Nestiwas,Rural,108,67,41,81,32,49
8,110,87,80436,0,0,RAJASTHAN,Jaipur,VILLAGE,Beer Talera,Rural,0,0,0,0,0,0
8,110,87,80437,0,0,RAJASTHAN,Jaipur,VILLAGE,Khurad,Rural,304,189,115,238,97,141
8,110,87,80438,0,0,RAJASTHAN,Jaipur,VILLAGE,Chimanpura @ Daab Ka Nala,Rural,573,376,197,495,168,327
8,110,87,80439,0,0,RAJASTHAN,Jaipur,VILLAGE,Amer Chak No.2,Rural,32,20,12,27,10,17
8,110,87,80440,0,0,RAJASTHAN,Jaipur,VILLAGE,Nagal Susawatan,Rural,3566,2368,1198,1523,539,984
8,110,87,80441,0,0,RAJASTHAN,Jaipur,VILLAGE,Amer Chak No.1,Rural,402,271,131,320,103,217
8,110,87,80442,0,0,RAJASTHAN,Jaipur,VILLAGE,Kishanpura @ Lalwas,Rural,646,458,188,311,118,193
8,110,87,80443,0,0,RAJASTHAN,Jaipur,TOWN,Akedadoongar (CT),Urban,5769,3574,2195,3293,1285,2008
8,110,88,0,0,0,RAJASTHAN,Jaipur,CD BLOCK,Jamwa Ramgarh,Total,164117,107493,56624,139119,50936,88183
8,110,88,0,0,0,RAJASTHAN,Jaipur,CD BLOCK,Jamwa Ramgarh,Rural,159419,104603,54816,136152,49841,86311
8,110,88,0,0,0,RAJASTHAN,Jaipur,CD BLOCK,Jamwa Ramgarh,Urban,4698,2890,1808,2967,1095,1872
8,110,88,80444,0,0,RAJASTHAN,Jaipur,VILLAGE,Haripura Brahmanan,Rural,202,134,68,108,50,58
8,110,88,80445,0,0,RAJASTHAN,Jaipur,VILLAGE,Ratanpura Haripura,Rural,1202,756,446,737,266,471
8,110,88,80446,0,0,RAJASTHAN,Jaipur,VILLAGE,Ratanpura Jatan,Rural,320,223,97,236,89,147
8,110,88,80447,0,0,RAJASTHAN,Jaipur,VILLAGE,Gathwari Meena,Rural,196,129,67,153,47,106
8,110,88,80448,0,0,RAJASTHAN,Jaipur,VILLAGE,Gathwari,Rural,2277,1445,832,1597,536,1061
8,110,88,80449,0,0,RAJASTHAN,Jaipur,VILLAGE,Bobari,Rural,1566,984,582,975,356,619
8,110,88,80450,0,0,RAJASTHAN,Jaipur,VILLAGE,Bamanwas,Rural,572,344,228,372,153,219
8,110,88,80451,0,0,RAJASTHAN,Jaipur,VILLAGE,Brijpura,Rural,389,247,142,302,130,172
8,110,88,80452,0,0,RAJASTHAN,Jaipur,VILLAGE,Gokalyawala,Rural,91,66,25,77,28,49
8,110,88,80453,0,0,RAJASTHAN,Jaipur,VILLAGE,Gol,Rural,364,260,104,316,104,212
8,110,88,80454,0,0,RAJASTHAN,Jaipur,VILLAGE,Todalari,Rural,646,419,227,643,251,392
8,110,88,80455,0,0,RAJASTHAN,Jaipur,VILLAGE,Kela Ka Bas,Rural,577,391,186,532,186,346
8,110,88,80456,0,0,RAJASTHAN,Jaipur,VILLAGE,Chilpali,Rural,423,292,131,603,252,351
8,110,88,80457,0,0,RAJASTHAN,Jaipur,VILLAGE,Doonga Ka Bas,Rural,280,198,82,310,117,193
8,110,88,80458,0,0,RAJASTHAN,Jaipur,VILLAGE,Nekawala,Rural,421,278,143,312,106,206
8,110,88,80459,0,0,RAJASTHAN,Jaipur,VILLAGE,Ajabpura,Rural,428,271,157,299,108,191
8,110,88,80460,0,0,RAJASTHAN,Jaipur,VILLAGE,Bhojpura,Rural,684,442,242,519,194,325
8,110,88,80461,0,0,RAJASTHAN,Jaipur,VILLAGE,Noorpur,Rural,433,304,129,482,175,307
8,110,88,80462,0,0,RAJASTHAN,Jaipur,VILLAGE,Dhaler,Rural,489,322,167,416,148,268
8,110,88,80463,0,0,RAJASTHAN,Jaipur,VILLAGE,Charanwas Gajaji,Rural,338,227,111,320,122,198
8,110,88,80464,0,0,RAJASTHAN,Jaipur,VILLAGE,Raopura,Rural,437,300,137,378,136,242
8,110,88,80465,0,0,RAJASTHAN,Jaipur,VILLAGE,Bhuranpura,Rural,746,499,247,623,240,383
8,110,88,80466,0,0,RAJASTHAN,Jaipur,VILLAGE,Jaichand Pura,Rural,1301,817,484,928,318,610
8,110,88,80467,0,0,RAJASTHAN,Jaipur,VILLAGE,Bara Dehra,Rural,440,293,147,370,129,241
8,110,88,80468,0,0,RAJASTHAN,Jaipur,VILLAGE,Ladipura,Rural,860,562,298,652,230,422
8,110,88,80469,0,0,RAJASTHAN,Jaipur,VILLAGE,Arjunpura,Rural,1091,690,401,742,267,475
8,110,88,80470,0,0,RAJASTHAN,Jaipur,VILLAGE,Dhaula,Rural,1624,1062,562,1191,437,754
8,110,88,80471,0,0,RAJASTHAN,Jaipur,VILLAGE,Dheerawas,Rural,404,299,105,618,247,371
8,110,88,80472,0,0,RAJASTHAN,Jaipur,VILLAGE,Jaisinghpura Was Bahlor,Rural,169,105,64,314,131,183
8,110,88,80473,0,0,RAJASTHAN,Jaipur,VILLAGE,Bahlor,Rural,1539,1093,446,2043,777,1266
8,110,88,80474,0,0,RAJASTHAN,Jaipur,VILLAGE,Dhekla,Rural,273,188,85,289,111,178
8,110,88,80475,0,0,RAJASTHAN,Jaipur,VILLAGE,Dantala Gujran,Rural,672,433,239,553,208,345
8,110,88,80476,0,0,RAJASTHAN,Jaipur,VILLAGE,Tala,Rural,3353,2289,1064,4347,1673,2674
8,110,88,80477,0,0,RAJASTHAN,Jaipur,VILLAGE,Majipura,Rural,1115,717,398,846,287,559
8,110,88,80478,0,0,RAJASTHAN,Jaipur,VILLAGE,Rajpurwas Tala,Rural,1087,696,391,904,347,557
8,110,88,80479,0,0,RAJASTHAN,Jaipur,VILLAGE,Chak Charanwas,Rural,426,270,156,403,159,244
8,110,88,80480,0,0,RAJASTHAN,Jaipur,VILLAGE,Charanwas @ Kali Pahari,Rural,742,449,293,457,157,300
8,110,88,80481,0,0,RAJASTHAN,Jaipur,VILLAGE,Bilod,Rural,592,434,158,747,280,467
8,110,88,80482,0,0,RAJASTHAN,Jaipur,VILLAGE,Tilak Nagar,Rural,527,385,142,611,235,376
8,110,88,80483,0,0,RAJASTHAN,Jaipur,VILLAGE,Dantala Meena,Rural,762,497,265,808,298,510
8,110,88,80484,0,0,RAJASTHAN,Jaipur,VILLAGE,Maliwas,Rural,267,174,93,294,113,181
8,110,88,80485,0,0,RAJASTHAN,Jaipur,VILLAGE,Mathasoola,Rural,1185,814,371,1506,609,897
8,110,88,80486,0,0,RAJASTHAN,Jaipur,VILLAGE,Lunetha,Rural,626,462,164,791,282,509
8,110,88,80487,0,0,RAJASTHAN,Jaipur,VILLAGE,Bhatt Ka Was,Rural,383,254,129,244,78,166
8,110,88,80488,0,0,RAJASTHAN,Jaipur,VILLAGE,Jodhrala,Rural,474,319,155,558,221,337
8,110,88,80489,0,0,RAJASTHAN,Jaipur,VILLAGE,Raisar,Rural,2363,1535,828,2165,869,1296
8,110,88,80490,0,0,RAJASTHAN,Jaipur,VILLAGE,Devitala,Rural,253,185,68,298,100,198
8,110,88,80491,0,0,RAJASTHAN,Jaipur,VILLAGE,Chainpura,Rural,331,264,67,548,208,340
8,110,88,80492,0,0,RAJASTHAN,Jaipur,VILLAGE,Darolai,Rural,203,147,56,332,136,196
8,110,88,80493,0,0,RAJASTHAN,Jaipur,VILLAGE,Kushalpura,Rural,734,467,267,705,294,411
8,110,88,80494,0,0,RAJASTHAN,Jaipur,VILLAGE,Manhagi,Rural,874,628,246,1104,432,672
8,110,88,80495,0,0,RAJASTHAN,Jaipur,VILLAGE,Kooda,Rural,397,286,111,489,193,296
8,110,88,80496,0,0,RAJASTHAN,Jaipur,VILLAGE,Anantpura,Rural,1,1,0,3,0,3
8,110,88,80497,0,0,RAJASTHAN,Jaipur,VILLAGE,Gopinathpura,Rural,187,121,66,284,123,161
8,110,88,80498,0,0,RAJASTHAN,Jaipur,VILLAGE,Gurha Harooka,Rural,186,129,57,194,76,118
8,110,88,80499,0,0,RAJASTHAN,Jaipur,VILLAGE,Nangal Tejsingh,Rural,216,141,75,228,84,144
8,110,88,80500,0,0,RAJASTHAN,Jaipur,VILLAGE,Rampura Bas Samred,Rural,48,33,15,40,18,22
8,110,88,80501,0,0,RAJASTHAN,Jaipur,VILLAGE,Samred Khurd,Rural,534,358,176,571,220,351
8,110,88,80502,0,0,RAJASTHAN,Jaipur,VILLAGE,Chainpurabas Dedwari,Rural,234,165,69,345,126,219
8,110,88,80503,0,0,RAJASTHAN,Jaipur,VILLAGE,Dedwari,Rural,122,75,47,144,47,97
8,110,88,80504,0,0,RAJASTHAN,Jaipur,VILLAGE,Toda Meena,Rural,1859,1271,588,2061,798,1263
8,110,88,80505,0,0,RAJASTHAN,Jaipur,VILLAGE,Jindon Ki Dhani,Rural,312,211,101,220,69,151
8,110,88,80506,0,0,RAJASTHAN,Jaipur,VILLAGE,Basna,Rural,448,303,145,439,176,263
8,110,88,80507,0,0,RAJASTHAN,Jaipur,VILLAGE,Goojron Ka Bas,Rural,198,132,66,218,67,151
8,110,88,80508,0,0,RAJASTHAN,Jaipur,VILLAGE,Paleeton Ki Dhani,Rural,192,126,66,154,57,97
8,110,88,80509,0,0,RAJASTHAN,Jaipur,VILLAGE,Chhapar,Rural,483,306,177,338,105,233
8,110,88,80510,0,0,RAJASTHAN,Jaipur,VILLAGE,Bhanpur Kalan,Rural,3348,2058,1290,1617,550,1067
8,110,88,80511,0,0,RAJASTHAN,Jaipur,VILLAGE,Teekampura,Rural,800,501,299,465,162,303
8,110,88,80512,0,0,RAJASTHAN,Jaipur,VILLAGE,Pali,Rural,500,336,164,420,132,288
8,110,88,80513,0,0,RAJASTHAN,Jaipur,VILLAGE,Bhattawala,Rural,343,242,101,273,101,172
8,110,88,80514,0,0,RAJASTHAN,Jaipur,VILLAGE,Bisori,Rural,324,212,112,260,91,169
8,110,88,80515,0,0,RAJASTHAN,Jaipur,VILLAGE,Nangal Tulsidas,Rural,1026,621,405,826,327,499
8,110,88,80516,0,0,RAJASTHAN,Jaipur,VILLAGE,Ghata Jaldhari,Rural,804,584,220,746,239,507
8,110,88,80517,0,0,RAJASTHAN,Jaipur,VILLAGE,Nimbhi,Rural,664,474,190,775,300,475
8,110,88,80518,0,0,RAJASTHAN,Jaipur,VILLAGE,Kelanwas,Rural,128,88,40,132,47,85
8,110,88,80519,0,0,RAJASTHAN,Jaipur,VILLAGE,Surethi,Rural,264,185,79,291,127,164
8,110,88,80520,0,0,RAJASTHAN,Jaipur,VILLAGE,Bhaogarh,Rural,215,153,62,304,117,187
8,110,88,80521,0,0,RAJASTHAN,Jaipur,VILLAGE,Godiyana,Rural,245,166,79,291,115,176
8,110,88,80522,0,0,RAJASTHAN,Jaipur,VILLAGE,Samred Kalan,Rural,1053,714,339,1145,427,718
8,110,88,80523,0,0,RAJASTHAN,Jaipur,VILLAGE,Manhagor,Rural,298,197,101,285,119,166
8,110,88,80524,0,0,RAJASTHAN,Jaipur,VILLAGE,Dantli,Rural,724,451,273,510,192,318
8,110,88,80525,0,0,RAJASTHAN,Jaipur,VILLAGE,Pawta,Rural,343,252,91,591,233,358
8,110,88,80526,0,0,RAJASTHAN,Jaipur,VILLAGE,Kanikhor,Rural,370,267,103,345,121,224
8,110,88,80527,0,0,RAJASTHAN,Jaipur,VILLAGE,Rasawala,Rural,87,52,35,151,61,90
8,110,88,80528,0,0,RAJASTHAN,Jaipur,VILLAGE,Beer Kanarwas,Rural,0,0,0,0,0,0
8,110,88,80529,0,0,RAJASTHAN,Jaipur,VILLAGE,Kali Barkhari,Rural,44,27,17,39,17,22
8,110,88,80530,0,0,RAJASTHAN,Jaipur,VILLAGE,Bassi,Rural,241,185,56,255,83,172
8,110,88,80531,0,0,RAJASTHAN,Jaipur,VILLAGE,Chak Dagota,Rural,0,0,0,0,0,0
8,110,88,80532,0,0,RAJASTHAN,Jaipur,VILLAGE,Dagota,Rural,824,531,293,585,219,366
8,110,88,80533,0,0,RAJASTHAN,Jaipur,VILLAGE,Shri Ramgopalpura,Rural,420,297,123,388,143,245
8,110,88,80534,0,0,RAJASTHAN,Jaipur,VILLAGE,Neemla,Rural,683,446,237,423,165,258
8,110,88,80535,0,0,RAJASTHAN,Jaipur,VILLAGE,Heengawala,Rural,195,143,52,175,55,120
8,110,88,80536,0,0,RAJASTHAN,Jaipur,VILLAGE,Kilatpuri,Rural,423,254,169,218,100,118
8,110,88,80537,0,0,RAJASTHAN,Jaipur,VILLAGE,Singhpuri,Rural,140,95,45,133,57,76
8,110,88,80538,0,0,RAJASTHAN,Jaipur,VILLAGE,Rayanwala,Rural,435,281,154,361,130,231
8,110,88,80539,0,0,RAJASTHAN,Jaipur,VILLAGE,Sankotra,Rural,1220,791,429,1008,364,644
8,110,88,80540,0,0,RAJASTHAN,Jaipur,VILLAGE,Patalwas,Rural,770,478,292,588,198,390
8,110,88,80541,0,0,RAJASTHAN,Jaipur,VILLAGE,Chak Dantli,Rural,240,146,94,139,50,89
8,110,88,80542,0,0,RAJASTHAN,Jaipur,VILLAGE,Bhawni Khurd,Rural,750,483,267,605,226,379
8,110,88,80543,0,0,RAJASTHAN,Jaipur,VILLAGE,Bhawni,Rural,511,323,188,358,131,227
8,110,88,80544,0,0,RAJASTHAN,Jaipur,VILLAGE,Kharad,Rural,816,495,321,664,258,406
8,110,88,80545,0,0,RAJASTHAN,Jaipur,VILLAGE,Bamanwati,Rural,182,114,68,220,92,128
8,110,88,80546,0,0,RAJASTHAN,Jaipur,VILLAGE,Shri Ramjipura,Rural,0,0,0,0,0,0
8,110,88,80547,0,0,RAJASTHAN,Jaipur,VILLAGE,Dhoret @ Harrampura,Rural,609,417,192,624,230,394
8,110,88,80548,0,0,RAJASTHAN,Jaipur,VILLAGE,Bhimawas,Rural,278,186,92,194,67,127
8,110,88,80549,0,0,RAJASTHAN,Jaipur,VILLAGE,Anoppura,Rural,456,315,141,503,184,319
8,110,88,80550,0,0,RAJASTHAN,Jaipur,VILLAGE,Ghati Ghan Shyampura,Rural,163,112,51,233,83,150
8,110,88,80551,0,0,RAJASTHAN,Jaipur,VILLAGE,Bitthalpur,Rural,43,28,15,84,32,52
8,110,88,80552,0,0,RAJASTHAN,Jaipur,VILLAGE,Narpatyawas,Rural,576,397,179,450,149,301
8,110,88,80553,0,0,RAJASTHAN,Jaipur,VILLAGE,Kolyana,Rural,703,476,227,541,167,374
8,110,88,80554,0,0,RAJASTHAN,Jaipur,VILLAGE,Khemawas @ Chugalpura,Rural,175,119,56,114,40,74
8,110,88,80555,0,0,RAJASTHAN,Jaipur,VILLAGE,Rampura @ Badiyawala,Rural,357,244,113,312,122,190
8,110,88,80556,0,0,RAJASTHAN,Jaipur,VILLAGE,Indragarh,Rural,1008,664,344,916,345,571
8,110,88,80557,0,0,RAJASTHAN,Jaipur,VILLAGE,Chainpurawas Saiwar,Rural,41,30,11,48,14,34
8,110,88,80558,0,0,RAJASTHAN,Jaipur,VILLAGE,Saiwar,Rural,1244,784,460,825,294,531
8,110,88,80559,0,0,RAJASTHAN,Jaipur,VILLAGE,Rampura @ Chawa Ki Nangal,Rural,410,270,140,361,138,223
8,110,88,80560,0,0,RAJASTHAN,Jaipur,VILLAGE,Ajabgarh @ Hari Ka Bas,Rural,374,241,133,362,132,230
8,110,88,80561,0,0,RAJASTHAN,Jaipur,VILLAGE,Natata,Rural,2466,1608,858,2236,797,1439
8,110,88,80562,0,0,RAJASTHAN,Jaipur,VILLAGE,Naradpura,Rural,2629,1512,1117,979,384,595
8,110,88,80563,0,0,RAJASTHAN,Jaipur,VILLAGE,Peepalawala,Rural,529,328,201,399,155,244
8,110,88,80564,0,0,RAJASTHAN,Jaipur,VILLAGE,Saipura,Rural,1624,1024,600,979,336,643
8,110,88,80565,0,0,RAJASTHAN,Jaipur,VILLAGE,Chak Chainpurawas Dakhil Kharij Saiwar,Rural,0,0,0,0,0,0
8,110,88,80566,0,0,RAJASTHAN,Jaipur,VILLAGE,Kushalpura,Rural,160,106,54,112,28,84
8,110,88,80567,0,0,RAJASTHAN,Jaipur,VILLAGE,Chak Chainpura,Rural,350,209,141,277,94,183
8,110,88,80568,0,0,RAJASTHAN,Jaipur,VILLAGE,Chak Mala Ki Nangal,Rural,434,267,167,291,114,177
8,110,88,80569,0,0,RAJASTHAN,Jaipur,VILLAGE,Chak Indra Garh,Rural,117,76,41,88,34,54
8,110,88,80570,0,0,RAJASTHAN,Jaipur,VILLAGE,Heerawala,Rural,41,25,16,28,9,19
8,110,88,80571,0,0,RAJASTHAN,Jaipur,VILLAGE,Malawala,Rural,466,283,183,298,112,186
8,110,88,80572,0,0,RAJASTHAN,Jaipur,VILLAGE,Nayabas,Rural,709,411,298,324,110,214
8,110,88,80573,0,0,RAJASTHAN,Jaipur,VILLAGE,Lali,Rural,543,327,216,215,82,133
8,110,88,80574,0,0,RAJASTHAN,Jaipur,VILLAGE,Nimariya,Rural,1194,768,426,1042,376,666
8,110,88,80575,0,0,RAJASTHAN,Jaipur,VILLAGE,Chaumukha,Rural,595,407,188,554,208,346
8,110,88,80576,0,0,RAJASTHAN,Jaipur,VILLAGE,Maid Rajsinghpura,Rural,718,471,247,603,227,376
8,110,88,80577,0,0,RAJASTHAN,Jaipur,VILLAGE,Vishanpura,Rural,66,46,20,46,14,32
8,110,88,80578,0,0,RAJASTHAN,Jaipur,VILLAGE,Gopalgarh,Rural,813,533,280,744,290,454
8,110,88,80579,0,0,RAJASTHAN,Jaipur,VILLAGE,Jamwa Ghat,Rural,335,217,118,334,119,215
8,110,88,80580,0,0,RAJASTHAN,Jaipur,VILLAGE,Raipur,Rural,1040,726,314,1080,389,691
8,110,88,80581,0,0,RAJASTHAN,Jaipur,VILLAGE,Bhagwan Pura,Rural,467,313,154,323,116,207
8,110,88,80582,0,0,RAJASTHAN,Jaipur,VILLAGE,Saipur,Rural,801,560,241,760,278,482
8,110,88,80583,0,0,RAJASTHAN,Jaipur,VILLAGE,Andhi,Rural,3953,2559,1394,3351,1276,2075
8,110,88,80584,0,0,RAJASTHAN,Jaipur,VILLAGE,Phootolao,Rural,739,456,283,471,173,298
8,110,88,80585,0,0,RAJASTHAN,Jaipur,VILLAGE,Rampurawas Thali,Rural,116,75,41,89,31,58
8,110,88,80586,0,0,RAJASTHAN,Jaipur,VILLAGE,Jagatsar @ Riksha,Rural,117,89,28,238,83,155
8,110,88,80587,0,0,RAJASTHAN,Jaipur,VILLAGE,Thali,Rural,1911,1275,636,1672,606,1066
8,110,88,80588,0,0,RAJASTHAN,Jaipur,VILLAGE,Guwara,Rural,283,193,90,235,84,151
8,110,88,80589,0,0,RAJASTHAN,Jaipur,VILLAGE,Srinagar,Rural,508,360,148,544,200,344
8,110,88,80590,0,0,RAJASTHAN,Jaipur,VILLAGE,Ramyanwala,Rural,1064,726,338,1101,373,728
8,110,88,80591,0,0,RAJASTHAN,Jaipur,VILLAGE,Nabhawala,Rural,954,626,328,627,192,435
8,110,88,80592,0,0,RAJASTHAN,Jaipur,VILLAGE,Shekhawala,Rural,290,195,95,229,83,146
8,110,88,80593,0,0,RAJASTHAN,Jaipur,VILLAGE,Chatarpura,Rural,463,326,137,527,182,345
8,110,88,80594,0,0,RAJASTHAN,Jaipur,VILLAGE,Dagarwara,Rural,1742,1123,619,1551,588,963
8,110,88,80595,0,0,RAJASTHAN,Jaipur,VILLAGE,Ramjipura,Rural,596,442,154,941,361,580
8,110,88,80596,0,0,RAJASTHAN,Jaipur,VILLAGE,Samor,Rural,391,244,147,251,84,167
8,110,88,80597,0,0,RAJASTHAN,Jaipur,VILLAGE,Ishwarsingh Pura,Rural,387,259,128,324,114,210
8,110,88,80598,0,0,RAJASTHAN,Jaipur,VILLAGE,Bhonda Khera,Rural,415,264,151,331,121,210
8,110,88,80599,0,0,RAJASTHAN,Jaipur,VILLAGE,Kanwarpura,Rural,258,160,98,281,120,161
8,110,88,80600,0,0,RAJASTHAN,Jaipur,VILLAGE,Chak Kanwarpura,Rural,0,0,0,0,0,0
8,110,88,80601,0,0,RAJASTHAN,Jaipur,VILLAGE,Gopalyawas,Rural,209,132,77,165,64,101
8,110,88,80602,0,0,RAJASTHAN,Jaipur,VILLAGE,Sri Ramnagar,Rural,444,300,144,462,177,285
8,110,88,80603,0,0,RAJASTHAN,Jaipur,VILLAGE,Toloopura,Rural,578,349,229,409,155,254
8,110,88,80604,0,0,RAJASTHAN,Jaipur,VILLAGE,Thaulai,Rural,2173,1454,719,1706,593,1113
8,110,88,80605,0,0,RAJASTHAN,Jaipur,VILLAGE,Asthal,Rural,550,375,175,511,177,334
8,110,88,80606,0,0,RAJASTHAN,Jaipur,VILLAGE,Barh Thaulai,Rural,30,18,12,33,9,24
8,110,88,80607,0,0,RAJASTHAN,Jaipur,VILLAGE,Jarunda,Rural,701,452,249,457,156,301
8,110,88,80608,0,0,RAJASTHAN,Jaipur,VILLAGE,Shivpura,Rural,124,90,34,210,90,120
8,110,88,80609,0,0,RAJASTHAN,Jaipur,VILLAGE,Khawa Raniji,Rural,3073,2027,1046,1986,626,1360
8,110,88,80610,0,0,RAJASTHAN,Jaipur,VILLAGE,Sau,Rural,582,397,185,721,271,450
8,110,88,80611,0,0,RAJASTHAN,Jaipur,VILLAGE,Sau Siran,Rural,443,304,139,541,217,324
8,110,88,80612,0,0,RAJASTHAN,Jaipur,VILLAGE,Rampurawas Ramgarh,Rural,643,398,245,545,226,319
8,110,88,80613,0,0,RAJASTHAN,Jaipur,VILLAGE,Dhaupura,Rural,580,374,206,309,89,220
8,110,88,80614,0,0,RAJASTHAN,Jaipur,VILLAGE,Moondla,Rural,669,454,215,487,156,331
8,110,88,80615,0,0,RAJASTHAN,Jaipur,VILLAGE,Roopwas,Rural,1004,558,446,432,189,243
8,110,88,80616,0,0,RAJASTHAN,Jaipur,VILLAGE,Palera,Rural,993,624,369,703,254,449
8,110,88,80617,0,0,RAJASTHAN,Jaipur,VILLAGE,Balkrishna Pura,Rural,624,365,259,317,118,199
8,110,88,80618,0,0,RAJASTHAN,Jaipur,VILLAGE,Chawand Ka Mand,Rural,1497,942,555,1061,391,670
8,110,88,80619,0,0,RAJASTHAN,Jaipur,VILLAGE,Dalooka Ka Barh,Rural,225,138,87,107,29,78
8,110,88,80620,0,0,RAJASTHAN,Jaipur,VILLAGE,Langareeywas,Rural,795,504,291,766,316,450
8,110,88,80621,0,0,RAJASTHAN,Jaipur,VILLAGE,Guwardi,Rural,378,233,145,274,97,177
8,110,88,80622,0,0,RAJASTHAN,Jaipur,VILLAGE,Mathura Das Pura,Rural,489,323,166,511,195,316
8,110,88,80623,0,0,RAJASTHAN,Jaipur,VILLAGE,Barh Radho Das Pura,Rural,0,0,0,0,0,0
8,110,88,80624,0,0,RAJASTHAN,Jaipur,VILLAGE,Dangarwara Khurd,Rural,920,617,303,916,347,569
8,110,88,80625,0,0,RAJASTHAN,Jaipur,VILLAGE,Chak Nondpura,Rural,4,3,1,28,14,14
8,110,88,80626,0,0,RAJASTHAN,Jaipur,VILLAGE,Raniyawas,Rural,1083,668,415,871,325,546
8,110,88,80627,0,0,RAJASTHAN,Jaipur,VILLAGE,Rahori,Rural,1050,685,365,973,349,624
8,110,88,80628,0,0,RAJASTHAN,Jaipur,VILLAGE,Nondpura,Rural,781,482,299,427,156,271
8,110,88,80629,0,0,RAJASTHAN,Jaipur,VILLAGE,Papar,Rural,1351,923,428,1294,459,835
8,110,88,80630,0,0,RAJASTHAN,Jaipur,VILLAGE,Harkishanpura,Rural,774,519,255,750,283,467
8,110,88,80631,0,0,RAJASTHAN,Jaipur,VILLAGE,Meeno Ka Barh,Rural,802,529,273,873,337,536
8,110,88,80632,0,0,RAJASTHAN,Jaipur,VILLAGE,Nayla,Rural,2837,1716,1121,1828,707,1121
8,110,88,80633,0,0,RAJASTHAN,Jaipur,VILLAGE,Ramjipura Was Nayala,Rural,782,477,305,518,189,329
8,110,88,80634,0,0,RAJASTHAN,Jaipur,VILLAGE,Kanariyawala,Rural,421,275,146,295,96,199
8,110,88,80635,0,0,RAJASTHAN,Jaipur,VILLAGE,Dyoda Doongar,Rural,807,545,262,867,317,550
8,110,88,80636,0,0,RAJASTHAN,Jaipur,VILLAGE,Arwari,Rural,352,253,99,407,139,268
8,110,88,80637,0,0,RAJASTHAN,Jaipur,VILLAGE,Jhol,Rural,403,285,118,364,138,226
8,110,88,80638,0,0,RAJASTHAN,Jaipur,VILLAGE,Sarjoli,Rural,1268,856,412,1073,375,698
8,110,88,80639,0,0,RAJASTHAN,Jaipur,VILLAGE,Goth Ki Patti,Rural,484,330,154,479,164,315
8,110,88,80640,0,0,RAJASTHAN,Jaipur,VILLAGE,Palri Kalan,Rural,407,292,115,334,117,217
8,110,88,80641,0,0,RAJASTHAN,Jaipur,VILLAGE,Kharkara,Rural,1075,661,414,784,335,449
8,110,88,80642,0,0,RAJASTHAN,Jaipur,VILLAGE,Palri Khurd,Rural,428,277,151,362,137,225
8,110,88,80643,0,0,RAJASTHAN,Jaipur,VILLAGE,Kharana,Rural,629,438,191,675,267,408
8,110,88,80644,0,0,RAJASTHAN,Jaipur,VILLAGE,Chak Palri,Rural,29,21,8,37,11,26
8,110,88,80645,0,0,RAJASTHAN,Jaipur,VILLAGE,Khemawas,Rural,513,315,198,301,127,174
8,110,88,80646,0,0,RAJASTHAN,Jaipur,VILLAGE,Gudhawas Nevar,Rural,360,240,120,249,98,151
8,110,88,80647,0,0,RAJASTHAN,Jaipur,VILLAGE,Gaonli,Rural,1196,814,382,1143,399,744
8,110,88,80648,0,0,RAJASTHAN,Jaipur,VILLAGE,Birasana,Rural,1386,869,517,1040,352,688
8,110,88,80649,0,0,RAJASTHAN,Jaipur,VILLAGE,Koochawas,Rural,129,86,43,105,36,69
8,110,88,80650,0,0,RAJASTHAN,Jaipur,VILLAGE,Shankarpura,Rural,476,324,152,481,173,308
8,110,88,80651,0,0,RAJASTHAN,Jaipur,VILLAGE,Chak Koochawas,Rural,54,39,15,48,15,33
8,110,88,80652,0,0,RAJASTHAN,Jaipur,VILLAGE,Nangal Bela,Rural,499,354,145,503,159,344
8,110,88,80653,0,0,RAJASTHAN,Jaipur,VILLAGE,Sarpura,Rural,392,303,89,497,165,332
8,110,88,80654,0,0,RAJASTHAN,Jaipur,VILLAGE,Koliwara,Rural,509,360,149,440,135,305
8,110,88,80655,0,0,RAJASTHAN,Jaipur,VILLAGE,Radha Govindpura,Rural,253,168,85,271,103,168
8,110,88,80656,0,0,RAJASTHAN,Jaipur,VILLAGE,Barh Rasoolpura,Rural,469,291,178,281,100,181
8,110,88,80657,0,0,RAJASTHAN,Jaipur,VILLAGE,Nangal Gogoriyan,Rural,394,278,116,315,88,227
8,110,88,80658,0,0,RAJASTHAN,Jaipur,VILLAGE,Lalwas,Rural,791,536,255,692,247,445
8,110,88,80659,0,0,RAJASTHAN,Jaipur,VILLAGE,Bhanpura Khurd,Rural,634,381,253,418,160,258
8,110,88,80660,0,0,RAJASTHAN,Jaipur,VILLAGE,Sundarpura,Rural,293,198,95,257,92,165
8,110,88,80661,0,0,RAJASTHAN,Jaipur,VILLAGE,Jaisinghpura,Rural,290,208,82,226,70,156
8,110,88,80662,0,0,RAJASTHAN,Jaipur,VILLAGE,Barh Khemawas,Rural,0,0,0,0,0,0
8,110,88,80663,0,0,RAJASTHAN,Jaipur,VILLAGE,Kherawas Newar,Rural,541,355,186,483,161,322
8,110,88,80664,0,0,RAJASTHAN,Jaipur,VILLAGE,Newar,Rural,1004,690,314,925,320,605
8,110,88,80665,0,0,RAJASTHAN,Jaipur,VILLAGE,Maksoodan Pura,Rural,197,137,60,159,56,103
8,110,88,80666,0,0,RAJASTHAN,Jaipur,VILLAGE,Booj,Rural,2475,1648,827,2651,992,1659
8,110,88,80667,0,0,RAJASTHAN,Jaipur,VILLAGE,Manota,Rural,624,414,210,665,247,418
8,110,88,80668,0,0,RAJASTHAN,Jaipur,VILLAGE,Bhaopura,Rural,1733,1125,608,1052,341,711
8,110,88,80669,0,0,RAJASTHAN,Jaipur,VILLAGE,Deeppura,Rural,788,538,250,547,177,370
8,110,88,80670,0,0,RAJASTHAN,Jaipur,VILLAGE,Chawandiya,Rural,2736,1805,931,1919,601,1318
8,110,88,80671,0,0,RAJASTHAN,Jaipur,VILLAGE,Khatehpura,Rural,444,309,135,351,125,226
8,110,88,80672,0,0,RAJASTHAN,Jaipur,VILLAGE,Barh Booj,Rural,118,80,38,89,22,67
8,110,88,80673,0,0,RAJASTHAN,Jaipur,VILLAGE,Jagmalpura,Rural,655,425,230,438,151,287
8,110,88,80674,0,0,RAJASTHAN,Jaipur,VILLAGE,Dhoola Raoji,Rural,1813,1247,566,1952,681,1271
8,110,88,80675,0,0,RAJASTHAN,Jaipur,VILLAGE,Heerapura,Rural,260,178,82,291,111,180
8,110,88,80676,0,0,RAJASTHAN,Jaipur,VILLAGE,Rampura Bas Chawandia,Rural,572,377,195,404,124,280
8,110,88,80677,0,0,RAJASTHAN,Jaipur,VILLAGE,Daulatpura,Rural,704,478,226,611,219,392
8,110,88,80678,0,0,RAJASTHAN,Jaipur,VILLAGE,Dharmpura,Rural,208,145,63,236,83,153
8,110,88,80679,0,0,RAJASTHAN,Jaipur,VILLAGE,Dhamsya,Rural,1272,809,463,942,330,612
8,110,88,80680,0,0,RAJASTHAN,Jaipur,VILLAGE,Chak Hurela,Rural,0,0,0,0,0,0
8,110,88,80681,0,0,RAJASTHAN,Jaipur,VILLAGE,Hurela,Rural,429,286,143,366,144,222
8,110,88,80682,0,0,RAJASTHAN,Jaipur,VILLAGE,Dadiya Patti,Rural,517,320,197,305,112,193
8,110,88,80683,0,0,RAJASTHAN,Jaipur,VILLAGE,Barh Dhamsya,Rural,230,148,82,140,43,97
8,110,88,80684,0,0,RAJASTHAN,Jaipur,VILLAGE,Potli,Rural,651,431,220,457,150,307
8,110,88,80685,0,0,RAJASTHAN,Jaipur,TOWN,Jamwa Ramgarh (CT),Urban,4698,2890,1808,2967,1095,1872
8,110,89,0,0,0,RAJASTHAN,Jaipur,CD BLOCK,Bassi,Total,162647,103680,58967,120947,43703,77244
8,110,89,0,0,0,RAJASTHAN,Jaipur,CD BLOCK,Bassi,Rural,132123,85116,47007,103042,37078,65964
8,110,89,0,0,0,RAJASTHAN,Jaipur,CD BLOCK,Bassi,Urban,30524,18564,11960,17905,6625,11280
8,110,89,80686,0,0,RAJASTHAN,Jaipur,VILLAGE,Dyodha Chor,Rural,1256,810,446,906,320,586
8,110,89,80687,0,0,RAJASTHAN,Jaipur,VILLAGE,Ramratanpura,Rural,536,321,215,332,125,207
8,110,89,80688,0,0,RAJASTHAN,Jaipur,VILLAGE,Harchandpura @ Balyawala,Rural,430,268,162,316,118,198
8,110,89,80689,0,0,RAJASTHAN,Jaipur,VILLAGE,Vijai Mukundpura @ Hirawala,Rural,1734,1118,616,1219,461,758
8,110,89,80690,0,0,RAJASTHAN,Jaipur,VILLAGE,Hardhyanpura,Rural,562,349,213,550,227,323
8,110,89,80691,0,0,RAJASTHAN,Jaipur,VILLAGE,Badh Swami,Rural,0,0,0,0,0,0
8,110,89,80692,0,0,RAJASTHAN,Jaipur,VILLAGE,Geela Ki Nangal,Rural,983,623,360,566,207,359
8,110,89,80693,0,0,RAJASTHAN,Jaipur,VILLAGE,Kuthara Khurd,Rural,1169,752,417,1011,378,633
8,110,89,80694,0,0,RAJASTHAN,Jaipur,VILLAGE,Kuthara Kalan,Rural,914,581,333,697,248,449
8,110,89,80695,0,0,RAJASTHAN,Jaipur,VILLAGE,Chak Ghati,Rural,87,56,31,52,17,35
8,110,89,80696,0,0,RAJASTHAN,Jaipur,VILLAGE,Sevapura,Rural,516,326,190,429,166,263
8,110,89,80697,0,0,RAJASTHAN,Jaipur,VILLAGE,Kho Ghati,Rural,392,261,131,265,72,193
8,110,89,80698,0,0,RAJASTHAN,Jaipur,VILLAGE,Ghata,Rural,1633,1114,519,1454,517,937
8,110,89,80699,0,0,RAJASTHAN,Jaipur,VILLAGE,Hardi,Rural,686,457,229,509,158,351
8,110,89,80700,0,0,RAJASTHAN,Jaipur,VILLAGE,Dayarampura,Rural,546,362,184,396,122,274
8,110,89,80701,0,0,RAJASTHAN,Jaipur,VILLAGE,Hingoniya,Rural,512,348,164,417,140,277
8,110,89,80702,0,0,RAJASTHAN,Jaipur,VILLAGE,Bhatesari,Rural,327,211,116,295,105,190
8,110,89,80703,0,0,RAJASTHAN,Jaipur,VILLAGE,Boorthal,Rural,1006,657,349,851,309,542
8,110,89,80704,0,0,RAJASTHAN,Jaipur,VILLAGE,Kanarwas,Rural,638,407,231,454,169,285
8,110,89,80705,0,0,RAJASTHAN,Jaipur,VILLAGE,Ramsinghpura,Rural,599,377,222,461,160,301
8,110,89,80706,0,0,RAJASTHAN,Jaipur,VILLAGE,Jeetawala,Rural,961,606,355,626,214,412
8,110,89,80707,0,0,RAJASTHAN,Jaipur,VILLAGE,Dudawala,Rural,525,333,192,437,178,259
8,110,89,80708,0,0,RAJASTHAN,Jaipur,VILLAGE,Ramsar Palawala,Rural,952,609,343,588,203,385
8,110,89,80709,0,0,RAJASTHAN,Jaipur,VILLAGE,Mansar Kheri,Rural,2161,1331,830,1501,601,900
8,110,89,80710,0,0,RAJASTHAN,Jaipur,VILLAGE,Mangarh Khokhawala,Rural,1309,842,467,914,321,593
8,110,89,80711,0,0,RAJASTHAN,Jaipur,VILLAGE,Bhawasar Isharwala,Rural,616,383,233,454,170,284
8,110,89,80712,0,0,RAJASTHAN,Jaipur,VILLAGE,Lasariya Goojran,Rural,321,212,109,276,105,171
8,110,89,80713,0,0,RAJASTHAN,Jaipur,VILLAGE,Himmatpura,Rural,250,144,106,142,50,92
8,110,89,80714,0,0,RAJASTHAN,Jaipur,VILLAGE,Gokulpura Lasariya,Rural,868,594,274,845,300,545
8,110,89,80715,0,0,RAJASTHAN,Jaipur,VILLAGE,Girdharipura,Rural,473,327,146,442,150,292
8,110,89,80716,0,0,RAJASTHAN,Jaipur,VILLAGE,Shri Rampura,Rural,543,341,202,422,159,263
8,110,89,80717,0,0,RAJASTHAN,Jaipur,VILLAGE,Sindoli,Rural,1170,800,370,1019,350,669
8,110,89,80718,0,0,RAJASTHAN,Jaipur,VILLAGE,Bala Ki Nangal,Rural,384,232,152,309,121,188
8,110,89,80719,0,0,RAJASTHAN,Jaipur,VILLAGE,Sankh Shyopuri,Rural,703,456,247,690,289,401
8,110,89,80720,0,0,RAJASTHAN,Jaipur,VILLAGE,Ralawata,Rural,362,234,128,271,111,160
8,110,89,80721,0,0,RAJASTHAN,Jaipur,VILLAGE,Vishansinghpura,Rural,505,311,194,332,120,212
8,110,89,80722,0,0,RAJASTHAN,Jaipur,VILLAGE,Rooppura,Rural,640,428,212,617,231,386
8,110,89,80723,0,0,RAJASTHAN,Jaipur,VILLAGE,Baseri,Rural,94,59,35,87,32,55
8,110,89,80724,0,0,RAJASTHAN,Jaipur,VILLAGE,Peepala Bai,Rural,518,334,184,508,199,309
8,110,89,80725,0,0,RAJASTHAN,Jaipur,VILLAGE,Hanumanpura,Rural,659,421,238,460,173,287
8,110,89,80726,0,0,RAJASTHAN,Jaipur,VILLAGE,Barala,Rural,494,326,168,354,122,232
8,110,89,80727,0,0,RAJASTHAN,Jaipur,VILLAGE,Khijooriya Brahmanan,Rural,586,364,222,541,211,330
8,110,89,80728,0,0,RAJASTHAN,Jaipur,VILLAGE,Keshopura,Rural,457,286,171,469,182,287
8,110,89,80729,0,0,RAJASTHAN,Jaipur,VILLAGE,Sambhariya,Rural,2328,1479,849,1839,709,1130
8,110,89,80730,0,0,RAJASTHAN,Jaipur,VILLAGE,Jagdishpura,Rural,556,362,194,507,184,323
8,110,89,80731,0,0,RAJASTHAN,Jaipur,VILLAGE,Abhay Pura,Rural,563,365,198,487,183,304
8,110,89,80732,0,0,RAJASTHAN,Jaipur,VILLAGE,Badh Rampura,Rural,119,80,39,98,34,64
8,110,89,80733,0,0,RAJASTHAN,Jaipur,VILLAGE,Achalpura,Rural,634,402,232,687,271,416
8,110,89,80734,0,0,RAJASTHAN,Jaipur,VILLAGE,Gangarampura,Rural,421,278,143,342,119,223
8,110,89,80735,0,0,RAJASTHAN,Jaipur,VILLAGE,Khijooriya Ahiran,Rural,253,156,97,197,75,122
8,110,89,80736,0,0,RAJASTHAN,Jaipur,VILLAGE,Khijooriya Jatan,Rural,508,330,178,435,183,252
8,110,89,80737,0,0,RAJASTHAN,Jaipur,VILLAGE,Gudha Phalyawas,Rural,377,248,129,341,132,209
8,110,89,80738,0,0,RAJASTHAN,Jaipur,VILLAGE,Maharajpura,Rural,362,238,124,388,158,230
8,110,89,80739,0,0,RAJASTHAN,Jaipur,VILLAGE,Shyampura Kacholiya,Rural,1164,757,407,883,351,532
8,110,89,80740,0,0,RAJASTHAN,Jaipur,VILLAGE,Rajpura,Rural,479,309,170,369,126,243
8,110,89,80741,0,0,RAJASTHAN,Jaipur,VILLAGE,Phalyawas,Rural,974,603,371,772,280,492
8,110,89,80742,0,0,RAJASTHAN,Jaipur,VILLAGE,Ratanpura,Rural,373,231,142,316,118,198
8,110,89,80743,0,0,RAJASTHAN,Jaipur,VILLAGE,Devapura,Rural,700,475,225,597,229,368
8,110,89,80744,0,0,RAJASTHAN,Jaipur,VILLAGE,Trilokpura,Rural,218,139,79,208,72,136
8,110,89,80745,0,0,RAJASTHAN,Jaipur,VILLAGE,Hari Rampura,Rural,360,220,140,298,101,197
8,110,89,80746,0,0,RAJASTHAN,Jaipur,VILLAGE,Beelwa Khurd,Rural,270,157,113,232,80,152
8,110,89,80747,0,0,RAJASTHAN,Jaipur,VILLAGE,Bainara,Rural,2133,1434,699,2077,777,1300
8,110,89,80748,0,0,RAJASTHAN,Jaipur,VILLAGE,Philsan Biharipura,Rural,827,519,308,567,209,358
8,110,89,80749,0,0,RAJASTHAN,Jaipur,VILLAGE,Bhonyawala,Rural,545,375,170,548,188,360
8,110,89,80750,0,0,RAJASTHAN,Jaipur,VILLAGE,Shyampura,Rural,918,607,311,594,211,383
8,110,89,80751,0,0,RAJASTHAN,Jaipur,VILLAGE,Chainpura,Rural,788,504,284,573,192,381
8,110,89,80752,0,0,RAJASTHAN,Jaipur,VILLAGE,Chak Shyampura,Rural,86,53,33,112,40,72
8,110,89,80753,0,0,RAJASTHAN,Jaipur,VILLAGE,Badhcharanwas,Rural,62,37,25,20,8,12
8,110,89,80754,0,0,RAJASTHAN,Jaipur,VILLAGE,Jhar,Rural,2977,1868,1109,1706,543,1163
8,110,89,80755,0,0,RAJASTHAN,Jaipur,VILLAGE,Doodhali,Rural,986,639,347,547,158,389
8,110,89,80756,0,0,RAJASTHAN,Jaipur,VILLAGE,Sujanpura,Rural,832,535,297,512,169,343
8,110,89,80757,0,0,RAJASTHAN,Jaipur,VILLAGE,Mohanpura,Rural,1792,1084,708,1067,369,698
8,110,89,80758,0,0,RAJASTHAN,Jaipur,VILLAGE,Rohtaspura,Rural,297,184,113,151,45,106
8,110,89,80759,0,0,RAJASTHAN,Jaipur,VILLAGE,Kalyanpura,Rural,624,412,212,389,125,264
8,110,89,80760,0,0,RAJASTHAN,Jaipur,VILLAGE,Rampurawas Doodhali,Rural,379,234,145,221,66,155
8,110,89,80761,0,0,RAJASTHAN,Jaipur,VILLAGE,Chorwara,Rural,484,316,168,406,144,262
8,110,89,80762,0,0,RAJASTHAN,Jaipur,VILLAGE,Todabhata,Rural,1330,864,466,1031,344,687
8,110,89,80763,0,0,RAJASTHAN,Jaipur,VILLAGE,Birajpura,Rural,946,599,347,632,209,423
8,110,89,80764,0,0,RAJASTHAN,Jaipur,VILLAGE,Damodarpura,Rural,1130,761,369,831,309,522
8,110,89,80765,0,0,RAJASTHAN,Jaipur,VILLAGE,Bhankri,Rural,316,199,117,295,101,194
8,110,89,80766,0,0,RAJASTHAN,Jaipur,VILLAGE,Akhaipura,Rural,392,283,109,356,105,251
8,110,89,80767,0,0,RAJASTHAN,Jaipur,VILLAGE,Bhajoopura,Rural,447,279,168,257,95,162
8,110,89,80768,0,0,RAJASTHAN,Jaipur,VILLAGE,Chak Bhajoopura,Rural,331,203,128,156,44,112
8,110,89,80769,0,0,RAJASTHAN,Jaipur,VILLAGE,Badh Bhajoopura,Rural,1,1,0,4,2,2
8,110,89,80770,0,0,RAJASTHAN,Jaipur,VILLAGE,Manoharpura,Rural,753,487,266,618,194,424
8,110,89,80771,0,0,RAJASTHAN,Jaipur,VILLAGE,Kishanpura,Rural,852,499,353,575,206,369
8,110,89,80772,0,0,RAJASTHAN,Jaipur,VILLAGE,Nayagaon,Rural,252,157,95,176,61,115
8,110,89,80773,0,0,RAJASTHAN,Jaipur,VILLAGE,Chak Dhedpura,Rural,0,0,0,0,0,0
8,110,89,80774,0,0,RAJASTHAN,Jaipur,VILLAGE,Dhindhol,Rural,472,275,197,303,109,194
8,110,89,80775,0,0,RAJASTHAN,Jaipur,VILLAGE,Shyampura @ Dhedhpura,Rural,332,214,118,307,118,189
8,110,89,80776,0,0,RAJASTHAN,Jaipur,VILLAGE,Peeliya,Rural,765,477,288,628,240,388
8,110,89,80777,0,0,RAJASTHAN,Jaipur,VILLAGE,Palawala Jatan,Rural,1054,664,390,728,262,466
8,110,89,80778,0,0,RAJASTHAN,Jaipur,VILLAGE,Chatarpura,Rural,754,463,291,647,249,398
8,110,89,80779,0,0,RAJASTHAN,Jaipur,VILLAGE,Khijooriya Tiwariyan,Rural,681,422,259,594,230,364
8,110,89,80780,0,0,RAJASTHAN,Jaipur,VILLAGE,Badh Mahadevpura,Rural,138,92,46,99,36,63
8,110,89,80781,0,0,RAJASTHAN,Jaipur,VILLAGE,Sawai Jaisinghpura,Rural,403,249,154,346,140,206
8,110,89,80782,0,0,RAJASTHAN,Jaipur,VILLAGE,Brahmpuri,Rural,326,200,126,327,127,200
8,110,89,80783,0,0,RAJASTHAN,Jaipur,VILLAGE,Jheenjha,Rural,592,330,262,360,137,223
8,110,89,80784,0,0,RAJASTHAN,Jaipur,VILLAGE,Khera Malookpura,Rural,343,200,143,306,132,174
8,110,89,80785,0,0,RAJASTHAN,Jaipur,VILLAGE,Moondli,Rural,1298,857,441,1096,385,711
8,110,89,80786,0,0,RAJASTHAN,Jaipur,VILLAGE,Shankarpura,Rural,459,299,160,402,154,248
8,110,89,80787,0,0,RAJASTHAN,Jaipur,VILLAGE,Kashipura,Rural,845,567,278,750,277,473
8,110,89,80788,0,0,RAJASTHAN,Jaipur,VILLAGE,Chatarpura,Rural,274,189,85,280,113,167
8,110,89,80789,0,0,RAJASTHAN,Jaipur,VILLAGE,Badh Ramrakhpura,Rural,75,53,22,71,31,40
8,110,89,80790,0,0,RAJASTHAN,Jaipur,VILLAGE,Nangal Karna,Rural,210,148,62,124,43,81
8,110,89,80791,0,0,RAJASTHAN,Jaipur,VILLAGE,Rampurawas Devgaon,Rural,644,400,244,540,204,336
8,110,89,80792,0,0,RAJASTHAN,Jaipur,VILLAGE,Ramrakhpura,Rural,231,165,66,307,123,184
8,110,89,80793,0,0,RAJASTHAN,Jaipur,VILLAGE,Chainpura @ Khiveraj Ka Bas,Rural,486,322,164,571,220,351
8,110,89,80794,0,0,RAJASTHAN,Jaipur,VILLAGE,Ghasipura,Rural,419,270,149,367,142,225
8,110,89,80795,0,0,RAJASTHAN,Jaipur,VILLAGE,Danau Khurd,Rural,746,481,265,514,192,322
8,110,89,80796,0,0,RAJASTHAN,Jaipur,VILLAGE,Danau Kalan,Rural,1391,876,515,928,382,546
8,110,89,80797,0,0,RAJASTHAN,Jaipur,VILLAGE,Bimalpura,Rural,681,439,242,629,259,370
8,110,89,80798,0,0,RAJASTHAN,Jaipur,VILLAGE,Deogaon,Rural,1118,701,417,936,329,607
8,110,89,80799,0,0,RAJASTHAN,Jaipur,VILLAGE,Khatepura,Rural,1000,659,341,1061,411,650
8,110,89,80800,0,0,RAJASTHAN,Jaipur,VILLAGE,Ramsinghpura,Rural,505,339,166,584,233,351
8,110,89,80801,0,0,RAJASTHAN,Jaipur,VILLAGE,Rooppura,Rural,424,270,154,369,133,236
8,110,89,80802,0,0,RAJASTHAN,Jaipur,VILLAGE,Morandi,Rural,411,267,144,330,140,190
8,110,89,80803,0,0,RAJASTHAN,Jaipur,VILLAGE,Shri Ramnagar,Rural,122,77,45,111,39,72
8,110,89,80804,0,0,RAJASTHAN,Jaipur,VILLAGE,Kundanpura,Rural,284,182,102,223,86,137
8,110,89,80805,0,0,RAJASTHAN,Jaipur,VILLAGE,Chak Naradpura,Rural,0,0,0,0,0,0
8,110,89,80806,0,0,RAJASTHAN,Jaipur,VILLAGE,Naradpura,Rural,418,238,180,249,91,158
8,110,89,80807,0,0,RAJASTHAN,Jaipur,VILLAGE,Toongi,Rural,544,353,191,388,120,268
8,110,89,80808,0,0,RAJASTHAN,Jaipur,VILLAGE,Nagrajpura,Rural,600,375,225,482,168,314
8,110,89,80809,0,0,RAJASTHAN,Jaipur,VILLAGE,Kanwarpura,Rural,398,223,175,429,172,257
8,110,89,80810,0,0,RAJASTHAN,Jaipur,VILLAGE,Karangarh,Rural,337,207,130,179,70,109
8,110,89,80811,0,0,RAJASTHAN,Jaipur,VILLAGE,Chandpura,Rural,106,62,44,55,21,34
8,110,89,80812,0,0,RAJASTHAN,Jaipur,VILLAGE,Chapriya,Rural,376,249,127,415,156,259
8,110,89,80813,0,0,RAJASTHAN,Jaipur,VILLAGE,Garh,Rural,1910,1197,713,1422,509,913
8,110,89,80814,0,0,RAJASTHAN,Jaipur,VILLAGE,Lalgarh,Rural,1698,1110,588,1304,447,857
8,110,89,80815,0,0,RAJASTHAN,Jaipur,VILLAGE,Hathipura,Rural,366,248,118,381,150,231
8,110,89,80816,0,0,RAJASTHAN,Jaipur,VILLAGE,Kishanpura,Rural,640,455,185,627,222,405
8,110,89,80817,0,0,RAJASTHAN,Jaipur,VILLAGE,Gudha Meena,Rural,804,551,253,568,197,371
8,110,89,80818,0,0,RAJASTHAN,Jaipur,VILLAGE,Charanwas,Rural,415,273,142,329,105,224
8,110,89,80819,0,0,RAJASTHAN,Jaipur,VILLAGE,Nai Ka Mahadev,Rural,12,11,1,7,5,2
8,110,89,80820,0,0,RAJASTHAN,Jaipur,VILLAGE,Chitori,Rural,202,133,69,277,115,162
8,110,89,80821,0,0,RAJASTHAN,Jaipur,VILLAGE,Nimora,Rural,278,181,97,232,89,143
8,110,89,80822,0,0,RAJASTHAN,Jaipur,VILLAGE,Malihala,Rural,526,355,171,386,113,273
8,110,89,80823,0,0,RAJASTHAN,Jaipur,VILLAGE,Khori,Rural,1391,927,464,1027,331,696
8,110,89,80824,0,0,RAJASTHAN,Jaipur,VILLAGE,Gothara,Rural,567,374,193,448,144,304
8,110,89,80825,0,0,RAJASTHAN,Jaipur,VILLAGE,Jatwara,Rural,3861,2426,1435,2335,781,1554
8,110,89,80826,0,0,RAJASTHAN,Jaipur,VILLAGE,Chakpotli,Rural,0,0,0,0,0,0
8,110,89,80827,0,0,RAJASTHAN,Jaipur,VILLAGE,Dopur,Rural,444,293,151,283,86,197
8,110,89,80828,0,0,RAJASTHAN,Jaipur,VILLAGE,Jhajhwar,Rural,875,544,331,437,132,305
8,110,89,80829,0,0,RAJASTHAN,Jaipur,VILLAGE,Kaneta,Rural,366,242,124,287,109,178
8,110,89,80830,0,0,RAJASTHAN,Jaipur,VILLAGE,Apreta,Rural,359,254,105,316,123,193
8,110,89,80831,0,0,RAJASTHAN,Jaipur,VILLAGE,Kishanpura,Rural,566,391,175,585,214,371
8,110,89,80832,0,0,RAJASTHAN,Jaipur,VILLAGE,Parasoli,Rural,776,503,273,587,203,384
8,110,89,80833,0,0,RAJASTHAN,Jaipur,VILLAGE,Borai,Rural,619,437,182,577,205,372
8,110,89,80834,0,0,RAJASTHAN,Jaipur,VILLAGE,Peipura,Rural,179,109,70,166,72,94
8,110,89,80835,0,0,RAJASTHAN,Jaipur,VILLAGE,Nangal Bohra,Rural,574,369,205,491,175,316
8,110,89,80836,0,0,RAJASTHAN,Jaipur,VILLAGE,Barwa,Rural,2186,1411,775,1561,511,1050
8,110,89,80837,0,0,RAJASTHAN,Jaipur,VILLAGE,Tahatara,Rural,1379,885,494,979,329,650
8,110,89,80838,0,0,RAJASTHAN,Jaipur,VILLAGE,Meethawas,Rural,618,395,223,451,153,298
8,110,89,80839,0,0,RAJASTHAN,Jaipur,VILLAGE,Laxmipura,Rural,328,228,100,282,90,192
8,110,89,80840,0,0,RAJASTHAN,Jaipur,VILLAGE,Chak Dayalpura,Rural,0,0,0,0,0,0
8,110,89,80841,0,0,RAJASTHAN,Jaipur,VILLAGE,Badh Babupura,Rural,99,74,25,74,18,56
8,110,89,80842,0,0,RAJASTHAN,Jaipur,VILLAGE,Dayal Pura,Rural,403,271,132,260,87,173
8,110,89,80843,0,0,RAJASTHAN,Jaipur,VILLAGE,Kherlawas,Rural,631,421,210,510,162,348
8,110,89,80844,0,0,RAJASTHAN,Jaipur,VILLAGE,Hans Mahal,Rural,542,355,187,352,113,239
8,110,89,80845,0,0,RAJASTHAN,Jaipur,VILLAGE,Madanpura,Rural,468,303,165,367,131,236
8,110,89,80846,0,0,RAJASTHAN,Jaipur,VILLAGE,Gadholi,Rural,389,260,129,330,105,225
8,110,89,80847,0,0,RAJASTHAN,Jaipur,VILLAGE,Peelarama,Rural,201,146,55,235,74,161
8,110,89,80848,0,0,RAJASTHAN,Jaipur,VILLAGE,Kaneti,Rural,812,540,272,681,250,431
8,110,89,80849,0,0,RAJASTHAN,Jaipur,VILLAGE,Bhateri,Rural,879,572,307,741,283,458
8,110,89,80850,0,0,RAJASTHAN,Jaipur,VILLAGE,Kanpuriya,Rural,271,173,98,286,99,187
8,110,89,80851,0,0,RAJASTHAN,Jaipur,VILLAGE,Prempura,Rural,222,147,75,192,77,115
8,110,89,80852,0,0,RAJASTHAN,Jaipur,VILLAGE,Ramjipura,Rural,401,274,127,328,107,221
8,110,89,80853,0,0,RAJASTHAN,Jaipur,VILLAGE,Patan,Rural,1837,1194,643,1528,555,973
8,110,89,80854,0,0,RAJASTHAN,Jaipur,VILLAGE,Ugawas,Rural,488,325,163,433,157,276
8,110,89,80855,0,0,RAJASTHAN,Jaipur,VILLAGE,Shrinagar,Rural,464,289,175,407,152,255
8,110,89,80856,0,0,RAJASTHAN,Jaipur,VILLAGE,Dheengar Ka Bas,Rural,216,144,72,252,89,163
8,110,89,80857,0,0,RAJASTHAN,Jaipur,VILLAGE,Tekchandpura,Rural,473,314,159,331,111,220
8,110,89,80858,0,0,RAJASTHAN,Jaipur,VILLAGE,Charangarh,Rural,416,274,142,390,156,234
8,110,89,80859,0,0,RAJASTHAN,Jaipur,VILLAGE,Rajpura Patalwas,Rural,1458,932,526,842,283,559
8,110,89,80860,0,0,RAJASTHAN,Jaipur,VILLAGE,Kho Rajyawala,Rural,63,48,15,62,19,43
8,110,89,80861,0,0,RAJASTHAN,Jaipur,VILLAGE,Rampura @ Chandaliya,Rural,240,159,81,209,89,120
8,110,89,80862,0,0,RAJASTHAN,Jaipur,VILLAGE,Lalpura,Rural,425,278,147,315,111,204
8,110,89,80863,0,0,RAJASTHAN,Jaipur,VILLAGE,Tilpatti,Rural,554,375,179,356,103,253
8,110,89,80864,0,0,RAJASTHAN,Jaipur,VILLAGE,Lalawala,Rural,236,152,84,166,54,112
8,110,89,80865,0,0,RAJASTHAN,Jaipur,VILLAGE,Chak Rojwari,Rural,93,75,18,109,42,67
8,110,89,80866,0,0,RAJASTHAN,Jaipur,VILLAGE,Bhoorla,Rural,779,508,271,677,227,450
8,110,89,80867,0,0,RAJASTHAN,Jaipur,VILLAGE,Rojwari,Rural,398,244,154,222,88,134
8,110,89,80868,0,0,RAJASTHAN,Jaipur,VILLAGE,Bawdi Ka Bas,Rural,181,120,61,153,63,90
8,110,89,80869,0,0,RAJASTHAN,Jaipur,VILLAGE,Mandrooppura,Rural,282,181,101,252,94,158
8,110,89,80870,0,0,RAJASTHAN,Jaipur,VILLAGE,Dholi,Rural,345,214,131,243,77,166
8,110,89,80871,0,0,RAJASTHAN,Jaipur,VILLAGE,Prithvipura,Rural,302,185,117,243,78,165
8,110,89,80872,0,0,RAJASTHAN,Jaipur,VILLAGE,Ramsar,Rural,235,160,75,282,105,177
8,110,89,80873,0,0,RAJASTHAN,Jaipur,VILLAGE,Chak Madhogarh,Rural,114,79,35,62,24,38
8,110,89,80874,0,0,RAJASTHAN,Jaipur,VILLAGE,Rajwas,Rural,575,407,168,698,247,451
8,110,89,80875,0,0,RAJASTHAN,Jaipur,VILLAGE,Madhogarh,Rural,1288,809,479,910,316,594
8,110,89,80876,0,0,RAJASTHAN,Jaipur,VILLAGE,Ratanpura,Rural,346,229,117,390,136,254
8,110,89,80877,0,0,RAJASTHAN,Jaipur,VILLAGE,Biharipura,Rural,168,103,65,125,44,81
8,110,89,80878,0,0,RAJASTHAN,Jaipur,VILLAGE,Gwalni,Rural,802,519,283,561,196,365
8,110,89,80879,0,0,RAJASTHAN,Jaipur,VILLAGE,Gumanpura,Rural,355,242,113,404,148,256
8,110,89,80880,0,0,RAJASTHAN,Jaipur,VILLAGE,Doobli,Rural,700,477,223,827,301,526
8,110,89,80881,0,0,RAJASTHAN,Jaipur,VILLAGE,Kelyawala,Rural,269,173,96,296,111,185
8,110,89,80882,0,0,RAJASTHAN,Jaipur,VILLAGE,Chak Toonga,Rural,33,24,9,25,9,16
8,110,89,80883,0,0,RAJASTHAN,Jaipur,VILLAGE,Toonga,Rural,4332,2628,1704,2554,937,1617
8,110,89,80884,0,0,RAJASTHAN,Jaipur,VILLAGE,Bhudarpura,Rural,428,277,151,369,138,231
8,110,89,80885,0,0,RAJASTHAN,Jaipur,VILLAGE,Ballupura,Rural,345,223,122,224,78,146
8,110,89,80886,0,0,RAJASTHAN,Jaipur,VILLAGE,Lalpura,Rural,315,207,108,208,67,141
8,110,89,80887,0,0,RAJASTHAN,Jaipur,VILLAGE,Akhaipura,Rural,288,193,95,245,85,160
8,110,89,80888,0,0,RAJASTHAN,Jaipur,VILLAGE,Siya Ka Was,Rural,367,243,124,384,145,239
8,110,89,80889,0,0,RAJASTHAN,Jaipur,VILLAGE,Himmatpura,Rural,681,456,225,632,232,400
8,110,89,80890,0,0,RAJASTHAN,Jaipur,VILLAGE,Anatpura,Rural,773,522,251,509,158,351
8,110,89,80891,0,0,RAJASTHAN,Jaipur,VILLAGE,Madhyawala,Rural,256,183,73,371,132,239
8,110,89,80892,0,0,RAJASTHAN,Jaipur,VILLAGE,Akhaipura,Rural,302,182,120,266,110,156
8,110,89,80893,0,0,RAJASTHAN,Jaipur,VILLAGE,Sawalyawala,Rural,608,384,224,374,130,244
8,110,89,80894,0,0,RAJASTHAN,Jaipur,VILLAGE,Chak Lawan,Rural,0,0,0,0,0,0
8,110,89,80895,0,0,RAJASTHAN,Jaipur,VILLAGE,Jairam Ka Bas,Rural,308,196,112,288,96,192
8,110,89,80896,0,0,RAJASTHAN,Jaipur,VILLAGE,Chak Deori,Rural,14,9,5,20,7,13
8,110,89,80897,0,0,RAJASTHAN,Jaipur,VILLAGE,Tiddiwala,Rural,236,155,81,191,58,133
8,110,89,80898,0,0,RAJASTHAN,Jaipur,TOWN,Kanota (CT),Urban,7280,4324,2956,3970,1556,2414
8,110,89,80899,0,0,RAJASTHAN,Jaipur,TOWN,Bassi (CT),Urban,16851,10120,6731,9178,3359,5819
8,110,89,80900,0,0,RAJASTHAN,Jaipur,TOWN,Baskhoh (CT),Urban,6393,4120,2273,4757,1710,3047
8,110,90,0,0,0,RAJASTHAN,Jaipur,CD BLOCK,Chaksu,Total,101269,65610,35659,88933,33178,55755
8,110,90,0,0,0,RAJASTHAN,Jaipur,CD BLOCK,Chaksu,Rural,101269,65610,35659,88933,33178,55755
8,110,90,0,0,0,RAJASTHAN,Jaipur,CD BLOCK,Chaksu,Urban,0,0,0,0,0,0
8,110,90,80901,0,0,RAJASTHAN,Jaipur,VILLAGE,Chak Laxmipura No. 1,Rural,0,0,0,0,0,0
8,110,90,80902,0,0,RAJASTHAN,Jaipur,VILLAGE,Chak Laxmipura No. 2,Rural,0,0,0,0,0,0
8,110,90,80903,0,0,RAJASTHAN,Jaipur,VILLAGE,Ranipura,Rural,68,41,27,46,17,29
8,110,90,80904,0,0,RAJASTHAN,Jaipur,VILLAGE,Jai Anandpura,Rural,163,96,67,117,48,69
8,110,90,80905,0,0,RAJASTHAN,Jaipur,VILLAGE,Nanjipura,Rural,80,55,25,74,22,52
8,110,90,80906,0,0,RAJASTHAN,Jaipur,VILLAGE,Narya Ka Bas,Rural,362,224,138,310,112,198
8,110,90,80907,0,0,RAJASTHAN,Jaipur,VILLAGE,Chak Chandlai No.1,Rural,11,8,3,10,2,8
8,110,90,80908,0,0,RAJASTHAN,Jaipur,VILLAGE,Malwa,Rural,285,186,99,193,55,138
8,110,90,80909,0,0,RAJASTHAN,Jaipur,VILLAGE,Chak Chandlai No.2,Rural,5,3,2,1,0,1
8,110,90,80910,0,0,RAJASTHAN,Jaipur,VILLAGE,Chandlai,Rural,4104,2587,1517,2857,1037,1820
8,110,90,80911,0,0,RAJASTHAN,Jaipur,VILLAGE,Kilkipura,Rural,251,163,88,128,33,95
8,110,90,80912,0,0,RAJASTHAN,Jaipur,VILLAGE,Shivdaspura,Rural,2426,1460,966,1582,577,1005
8,110,90,80913,0,0,RAJASTHAN,Jaipur,VILLAGE,Barh Ramzanipura,Rural,91,58,33,66,27,39
8,110,90,80914,0,0,RAJASTHAN,Jaipur,VILLAGE,Khera Jagannathpura,Rural,337,207,130,275,101,174
8,110,90,80915,0,0,RAJASTHAN,Jaipur,VILLAGE,Gordhanpura,Rural,61,42,19,45,12,33
8,110,90,80916,0,0,RAJASTHAN,Jaipur,VILLAGE,Rampura Bas Goner,Rural,410,276,134,335,101,234
8,110,90,80917,0,0,RAJASTHAN,Jaipur,VILLAGE,Chakshivdaspura No1,Rural,132,80,52,131,49,82
8,110,90,80918,0,0,RAJASTHAN,Jaipur,VILLAGE,Pachoora,Rural,254,160,94,177,59,118
8,110,90,80919,0,0,RAJASTHAN,Jaipur,VILLAGE,Maksoodanpura @ Bara Padampura,Rural,633,385,248,448,163,285
8,110,90,80920,0,0,RAJASTHAN,Jaipur,VILLAGE,Chatarbhujpura,Rural,30,23,7,41,17,24
8,110,90,80921,0,0,RAJASTHAN,Jaipur,VILLAGE,Santoshpura,Rural,287,184,103,227,89,138
8,110,90,80922,0,0,RAJASTHAN,Jaipur,VILLAGE,Chak Shivdaspura No. 2,Rural,34,19,15,13,7,6
8,110,90,80923,0,0,RAJASTHAN,Jaipur,VILLAGE,Deokinandanpura,Rural,315,211,104,197,63,134
8,110,90,80924,0,0,RAJASTHAN,Jaipur,VILLAGE,Swaimadhosinghpura,Rural,195,120,75,106,33,73
8,110,90,80925,0,0,RAJASTHAN,Jaipur,VILLAGE,Dhorala,Rural,246,153,93,224,89,135
8,110,90,80926,0,0,RAJASTHAN,Jaipur,VILLAGE,Peeplyabai Ka Barh,Rural,101,69,32,115,38,77
8,110,90,80927,0,0,RAJASTHAN,Jaipur,VILLAGE,Dharmpura,Rural,418,236,182,160,65,95
8,110,90,80928,0,0,RAJASTHAN,Jaipur,VILLAGE,Balloopura,Rural,543,309,234,299,129,170
8,110,90,80929,0,0,RAJASTHAN,Jaipur,VILLAGE,Bhadadwas,Rural,370,261,109,450,183,267
8,110,90,80930,0,0,RAJASTHAN,Jaipur,VILLAGE,Bagariya,Rural,363,252,111,404,142,262
8,110,90,80931,0,0,RAJASTHAN,Jaipur,VILLAGE,Achalpura,Rural,479,305,174,360,140,220
8,110,90,80932,0,0,RAJASTHAN,Jaipur,VILLAGE,Sitarampura,Rural,221,155,66,247,96,151
8,110,90,80933,0,0,RAJASTHAN,Jaipur,VILLAGE,Narpatpura @ Haripura,Rural,288,186,102,160,53,107
8,110,90,80934,0,0,RAJASTHAN,Jaipur,VILLAGE,Chak Thooni,Rural,0,0,0,0,0,0
8,110,90,80935,0,0,RAJASTHAN,Jaipur,VILLAGE,Ram Kishanpura @ Thooni Mangaldas,Rural,440,297,143,384,136,248
8,110,90,80936,0,0,RAJASTHAN,Jaipur,VILLAGE,Barh Baldeopura,Rural,337,223,114,369,149,220
8,110,90,80937,0,0,RAJASTHAN,Jaipur,VILLAGE,Brijrajpura,Rural,260,180,80,189,66,123
8,110,90,80938,0,0,RAJASTHAN,Jaipur,VILLAGE,Bodya Ka Barh,Rural,13,11,2,10,2,8
8,110,90,80939,0,0,RAJASTHAN,Jaipur,VILLAGE,Bhagwatpura,Rural,366,216,150,235,102,133
8,110,90,80940,0,0,RAJASTHAN,Jaipur,VILLAGE,Ramzanipura,Rural,577,368,209,559,210,349
8,110,90,80941,0,0,RAJASTHAN,Jaipur,VILLAGE,Barh Chandpura,Rural,304,185,119,272,119,153
8,110,90,80942,0,0,RAJASTHAN,Jaipur,VILLAGE,Chak Chandpura,Rural,41,28,13,15,3,12
8,110,90,80943,0,0,RAJASTHAN,Jaipur,VILLAGE,Roopaheri Kalan,Rural,1049,673,376,1069,421,648
8,110,90,80944,0,0,RAJASTHAN,Jaipur,VILLAGE,God Ka Bas,Rural,691,457,234,588,216,372
8,110,90,80945,0,0,RAJASTHAN,Jaipur,VILLAGE,Harinarayanpura,Rural,774,509,265,724,276,448
8,110,90,80946,0,0,RAJASTHAN,Jaipur,VILLAGE,Madhopura,Rural,673,427,246,377,141,236
8,110,90,80947,0,0,RAJASTHAN,Jaipur,VILLAGE,Hingoti,Rural,513,318,195,509,207,302
8,110,90,80948,0,0,RAJASTHAN,Jaipur,VILLAGE,Mahadeopura,Rural,793,517,276,805,305,500
8,110,90,80949,0,0,RAJASTHAN,Jaipur,VILLAGE,Koonpa Ka Bas,Rural,382,257,125,410,133,277
8,110,90,80950,0,0,RAJASTHAN,Jaipur,VILLAGE,Tajkhan Ka Bas,Rural,603,395,208,608,240,368
8,110,90,80951,0,0,RAJASTHAN,Jaipur,VILLAGE,Damodar Ka Bas,Rural,509,343,166,492,199,293
8,110,90,80952,0,0,RAJASTHAN,Jaipur,VILLAGE,Chak Shri Kishanpura No.2,Rural,8,7,1,30,12,18
8,110,90,80953,0,0,RAJASTHAN,Jaipur,VILLAGE,Mandawari,Rural,67,40,27,92,41,51
8,110,90,80954,0,0,RAJASTHAN,Jaipur,VILLAGE,Balrampura,Rural,157,99,58,108,45,63
8,110,90,80955,0,0,RAJASTHAN,Jaipur,VILLAGE,Balrampura Chak No.1,Rural,55,38,17,56,22,34
8,110,90,80956,0,0,RAJASTHAN,Jaipur,VILLAGE,Chak Shri Kishanpura No.1,Rural,0,0,0,0,0,0
8,110,90,80957,0,0,RAJASTHAN,Jaipur,VILLAGE,Shri Kishanpura,Rural,120,82,38,128,57,71
8,110,90,80958,0,0,RAJASTHAN,Jaipur,VILLAGE,Chak Balram Pura No.2,Rural,13,6,7,5,2,3
8,110,90,80959,0,0,RAJASTHAN,Jaipur,VILLAGE,Chak Tajkhan Ka Bas,Rural,0,0,0,0,0,0
8,110,90,80960,0,0,RAJASTHAN,Jaipur,VILLAGE,Indrapuri,Rural,407,261,146,333,132,201
8,110,90,80961,0,0,RAJASTHAN,Jaipur,VILLAGE,Kot Khawada,Rural,5289,3313,1976,4052,1568,2484
8,110,90,80962,0,0,RAJASTHAN,Jaipur,VILLAGE,Jag Rampura,Rural,230,146,84,265,112,153
8,110,90,80963,0,0,RAJASTHAN,Jaipur,VILLAGE,Radoli,Rural,545,340,205,370,128,242
8,110,90,80964,0,0,RAJASTHAN,Jaipur,VILLAGE,Bhagwatsar Kankariya,Rural,190,129,61,162,63,99
8,110,90,80965,0,0,RAJASTHAN,Jaipur,VILLAGE,Sawai Jaisinghpura,Rural,365,250,115,347,132,215
8,110,90,80966,0,0,RAJASTHAN,Jaipur,VILLAGE,Barh Moondaheri,Rural,0,0,0,0,0,0
8,110,90,80967,0,0,RAJASTHAN,Jaipur,VILLAGE,Moondaheri,Rural,432,270,162,390,148,242
8,110,90,80968,0,0,RAJASTHAN,Jaipur,VILLAGE,Ugariyawas,Rural,130,81,49,73,22,51
8,110,90,80969,0,0,RAJASTHAN,Jaipur,VILLAGE,Bilaspura,Rural,244,167,77,206,85,121
8,110,90,80970,0,0,RAJASTHAN,Jaipur,VILLAGE,Roopaheri Khurd With Bapugaon,Rural,1163,739,424,978,350,628
8,110,90,80971,0,0,RAJASTHAN,Jaipur,VILLAGE,Maharampura,Rural,278,180,98,264,99,165
8,110,90,80972,0,0,RAJASTHAN,Jaipur,VILLAGE,Firojpura @ Bibi Ka Barh,Rural,297,198,99,360,162,198
8,110,90,80973,0,0,RAJASTHAN,Jaipur,VILLAGE,Chhadel Khurd,Rural,361,225,136,296,128,168
8,110,90,80974,0,0,RAJASTHAN,Jaipur,VILLAGE,Chhadel Kalan,Rural,481,297,184,316,101,215
8,110,90,80975,0,0,RAJASTHAN,Jaipur,VILLAGE,Ramlaxman Pura @ Thooni,Rural,138,101,37,150,61,89
8,110,90,80976,0,0,RAJASTHAN,Jaipur,VILLAGE,Beer Pinarpura,Rural,499,330,169,477,175,302
8,110,90,80977,0,0,RAJASTHAN,Jaipur,VILLAGE,Barh Mahawatan,Rural,235,139,96,162,48,114
8,110,90,80978,0,0,RAJASTHAN,Jaipur,VILLAGE,Bhagwanpura,Rural,209,137,72,172,63,109
8,110,90,80979,0,0,RAJASTHAN,Jaipur,VILLAGE,Ganeshpura,Rural,214,150,64,167,44,123
8,110,90,80980,0,0,RAJASTHAN,Jaipur,VILLAGE,Nimodiya,Rural,1410,909,501,1104,386,718
8,110,90,80981,0,0,RAJASTHAN,Jaipur,VILLAGE,Akodiya,Rural,841,546,295,805,284,521
8,110,90,80982,0,0,RAJASTHAN,Jaipur,VILLAGE,Khajalpura,Rural,874,556,318,636,249,387
8,110,90,80983,0,0,RAJASTHAN,Jaipur,VILLAGE,Bhawanipura,Rural,290,179,111,158,52,106
8,110,90,80984,0,0,RAJASTHAN,Jaipur,VILLAGE,Nangal Pooran,Rural,405,252,153,399,142,257
8,110,90,80985,0,0,RAJASTHAN,Jaipur,VILLAGE,Raipuriya Khurd,Rural,462,286,176,282,106,176
8,110,90,80986,0,0,RAJASTHAN,Jaipur,VILLAGE,Thooni Jailalpura,Rural,152,107,45,112,38,74
8,110,90,80987,0,0,RAJASTHAN,Jaipur,VILLAGE,Barkhera,Rural,946,560,386,727,289,438
8,110,90,80988,0,0,RAJASTHAN,Jaipur,VILLAGE,Sadashivpura @ Yarlipura,Rural,395,252,143,351,121,230
8,110,90,80989,0,0,RAJASTHAN,Jaipur,VILLAGE,Laxmipura @ Kathawala,Rural,401,263,138,315,107,208
8,110,90,80990,0,0,RAJASTHAN,Jaipur,VILLAGE,Gopirampura,Rural,187,127,60,192,79,113
8,110,90,80991,0,0,RAJASTHAN,Jaipur,VILLAGE,Salagrampura,Rural,382,246,136,317,127,190
8,110,90,80992,0,0,RAJASTHAN,Jaipur,VILLAGE,Dahar,Rural,469,265,204,192,87,105
8,110,90,80993,0,0,RAJASTHAN,Jaipur,VILLAGE,Roopniwas@Thooni,Rural,122,75,47,127,55,72
8,110,90,80994,0,0,RAJASTHAN,Jaipur,VILLAGE,Hukkan,Rural,206,135,71,185,73,112
8,110,90,80995,0,0,RAJASTHAN,Jaipur,VILLAGE,Siroojyan,Rural,172,115,57,139,57,82
8,110,90,80996,0,0,RAJASTHAN,Jaipur,VILLAGE,Laxmipura(Laxmanpura),Rural,75,45,30,85,36,49
8,110,90,80997,0,0,RAJASTHAN,Jaipur,VILLAGE,Dayapura,Rural,178,112,66,167,67,100
8,110,90,80998,0,0,RAJASTHAN,Jaipur,VILLAGE,Lakhawas,Rural,251,149,102,223,80,143
8,110,90,80999,0,0,RAJASTHAN,Jaipur,VILLAGE,Dadanpura,Rural,212,135,77,227,89,138
8,110,90,81000,0,0,RAJASTHAN,Jaipur,VILLAGE,Jhujharpura,Rural,59,37,22,62,30,32
8,110,90,81001,0,0,RAJASTHAN,Jaipur,VILLAGE,Biharipura(Rural),Rural,214,122,92,206,83,123
8,110,90,81002,0,0,RAJASTHAN,Jaipur,VILLAGE,Janki Ballabhpura,Rural,183,126,57,114,38,76
8,110,90,81003,0,0,RAJASTHAN,Jaipur,VILLAGE,Beer Suratrampura,Rural,204,121,83,160,66,94
8,110,90,81004,0,0,RAJASTHAN,Jaipur,VILLAGE,Manpur Doongri,Rural,431,268,163,264,109,155
8,110,90,81005,0,0,RAJASTHAN,Jaipur,VILLAGE,Rampura Bujurg,Rural,190,122,68,242,97,145
8,110,90,81006,0,0,RAJASTHAN,Jaipur,VILLAGE,Kalyanpura,Rural,479,321,158,401,140,261
8,110,90,81007,0,0,RAJASTHAN,Jaipur,VILLAGE,Kareda Khurd,Rural,578,374,204,410,134,276
8,110,90,81008,0,0,RAJASTHAN,Jaipur,VILLAGE,Dragpalpura,Rural,308,214,94,342,136,206
8,110,90,81009,0,0,RAJASTHAN,Jaipur,VILLAGE,Azamnagar,Rural,334,192,142,195,74,121
8,110,90,81010,0,0,RAJASTHAN,Jaipur,VILLAGE,Chosla,Rural,335,215,120,332,133,199
8,110,90,81011,0,0,RAJASTHAN,Jaipur,VILLAGE,Narharpura,Rural,394,255,139,254,85,169
8,110,90,81012,0,0,RAJASTHAN,Jaipur,VILLAGE,Udaipura,Rural,509,322,187,343,108,235
8,110,90,81013,0,0,RAJASTHAN,Jaipur,VILLAGE,Puroshottampura @Aleewas,Rural,410,251,159,266,81,185
8,110,90,81014,0,0,RAJASTHAN,Jaipur,VILLAGE,Chak Shri Kishanpura,Rural,0,0,0,0,0,0
8,110,90,81015,0,0,RAJASTHAN,Jaipur,VILLAGE,Bhojya Dand,Rural,328,217,111,270,93,177
8,110,90,81016,0,0,RAJASTHAN,Jaipur,VILLAGE,Brijnathpura,Rural,412,286,126,281,88,193
8,110,90,81017,0,0,RAJASTHAN,Jaipur,VILLAGE,Prahladpura @ Damakpura,Rural,28,15,13,13,5,8
8,110,90,81018,0,0,RAJASTHAN,Jaipur,VILLAGE,Jaichandpura,Rural,383,244,139,279,98,181
8,110,90,81019,0,0,RAJASTHAN,Jaipur,VILLAGE,Seemlyawas Watka,Rural,610,399,211,419,134,285
8,110,90,81020,0,0,RAJASTHAN,Jaipur,VILLAGE,Chakwatka,Rural,11,10,1,7,1,6
8,110,90,81021,0,0,RAJASTHAN,Jaipur,VILLAGE,Fatehpurawas Watka,Rural,723,459,264,483,163,320
8,110,90,81022,0,0,RAJASTHAN,Jaipur,VILLAGE,Kumhariyawas,Rural,543,346,197,370,127,243
8,110,90,81023,0,0,RAJASTHAN,Jaipur,VILLAGE,Bajdoli,Rural,492,305,187,389,149,240
8,110,90,81024,0,0,RAJASTHAN,Jaipur,VILLAGE,Shri Sawai Jaisinghpura,Rural,348,222,126,365,155,210
8,110,90,81025,0,0,RAJASTHAN,Jaipur,VILLAGE,Sitarampura @ Gogyawas,Rural,176,122,54,194,65,129
8,110,90,81026,0,0,RAJASTHAN,Jaipur,VILLAGE,Vinodilalpura,Rural,312,215,97,316,106,210
8,110,90,81027,0,0,RAJASTHAN,Jaipur,VILLAGE,Bhojyara,Rural,935,616,319,879,328,551
8,110,90,81028,0,0,RAJASTHAN,Jaipur,VILLAGE,Surajpura @ Tootoli,Rural,972,644,328,1159,482,677
8,110,90,81029,0,0,RAJASTHAN,Jaipur,VILLAGE,Shri Daulatpura,Rural,15,9,6,15,6,9
8,110,90,81030,0,0,RAJASTHAN,Jaipur,VILLAGE,Teetriya,Rural,2013,1283,730,1319,428,891
8,110,90,81031,0,0,RAJASTHAN,Jaipur,VILLAGE,Shri Kishanpura,Rural,241,151,90,208,72,136
8,110,90,81032,0,0,RAJASTHAN,Jaipur,VILLAGE,Deo Kishanpura,Rural,539,360,179,554,211,343
8,110,90,81033,0,0,RAJASTHAN,Jaipur,VILLAGE,Sadarampura,Rural,214,141,73,166,67,99
8,110,90,81034,0,0,RAJASTHAN,Jaipur,VILLAGE,Murarpura,Rural,30,14,16,35,21,14
8,110,90,81035,0,0,RAJASTHAN,Jaipur,VILLAGE,Chak Murarpura,Rural,3,2,1,9,2,7
8,110,90,81036,0,0,RAJASTHAN,Jaipur,VILLAGE,Thali,Rural,1211,833,378,1380,527,853
8,110,90,81037,0,0,RAJASTHAN,Jaipur,VILLAGE,Mumararkya,Rural,239,165,74,197,60,137
8,110,90,81038,0,0,RAJASTHAN,Jaipur,VILLAGE,Mansar,Rural,245,151,94,208,81,127
8,110,90,81039,0,0,RAJASTHAN,Jaipur,VILLAGE,Kadera,Rural,1345,851,494,1073,385,688
8,110,90,81040,0,0,RAJASTHAN,Jaipur,VILLAGE,Ankeshpura,Rural,258,161,97,175,59,116
8,110,90,81041,0,0,RAJASTHAN,Jaipur,VILLAGE,Kiratpura,Rural,224,157,67,284,119,165
8,110,90,81042,0,0,RAJASTHAN,Jaipur,VILLAGE,Kriparampura,Rural,278,171,107,162,47,115
8,110,90,81043,0,0,RAJASTHAN,Jaipur,VILLAGE,Trilokpura,Rural,293,203,90,184,46,138
8,110,90,81044,0,0,RAJASTHAN,Jaipur,VILLAGE,Bhadipura @ Narayanpura,Rural,233,144,89,188,71,117
8,110,90,81045,0,0,RAJASTHAN,Jaipur,VILLAGE,Harivallabhpura,Rural,188,122,66,155,59,96
8,110,90,81046,0,0,RAJASTHAN,Jaipur,VILLAGE,Tamariya,Rural,966,646,320,870,305,565
8,110,90,81047,0,0,RAJASTHAN,Jaipur,VILLAGE,Shri Vallabhpura,Rural,0,0,0,0,0,0
8,110,90,81048,0,0,RAJASTHAN,Jaipur,VILLAGE,Khejri Bujurg,Rural,591,411,180,423,146,277
8,110,90,81049,0,0,RAJASTHAN,Jaipur,VILLAGE,Shri Jaideopura,Rural,35,22,13,37,15,22
8,110,90,81050,0,0,RAJASTHAN,Jaipur,VILLAGE,Sewapura,Rural,193,130,63,145,50,95
8,110,90,81051,0,0,RAJASTHAN,Jaipur,VILLAGE,Barh Bagpura,Rural,667,433,234,499,165,334
8,110,90,81052,0,0,RAJASTHAN,Jaipur,VILLAGE,Hansrajpura,Rural,31,21,10,20,6,14
8,110,90,81053,0,0,RAJASTHAN,Jaipur,VILLAGE,Meerapura,Rural,164,107,57,122,46,76
8,110,90,81054,0,0,RAJASTHAN,Jaipur,VILLAGE,Rasoolpura,Rural,619,391,228,506,168,338
8,110,90,81055,0,0,RAJASTHAN,Jaipur,VILLAGE,Roopbas,Rural,343,211,132,236,92,144
8,110,90,81056,0,0,RAJASTHAN,Jaipur,VILLAGE,Jaipura,Rural,277,185,92,297,112,185
8,110,90,81057,0,0,RAJASTHAN,Jaipur,VILLAGE,Dhoosari,Rural,432,284,148,365,129,236
8,110,90,81058,0,0,RAJASTHAN,Jaipur,VILLAGE,Anandrampura,Rural,480,308,172,254,74,180
8,110,90,81059,0,0,RAJASTHAN,Jaipur,VILLAGE,Deogaon,Rural,144,100,44,127,40,87
8,110,90,81060,0,0,RAJASTHAN,Jaipur,VILLAGE,Dalpatpura,Rural,253,163,90,136,44,92
8,110,90,81061,0,0,RAJASTHAN,Jaipur,VILLAGE,Shri Ganeshpura,Rural,124,88,36,130,38,92
8,110,90,81062,0,0,RAJASTHAN,Jaipur,VILLAGE,Lasariya,Rural,278,198,80,277,93,184
8,110,90,81063,0,0,RAJASTHAN,Jaipur,VILLAGE,Sawai Madhosinghpura,Rural,596,389,207,480,148,332
8,110,90,81064,0,0,RAJASTHAN,Jaipur,VILLAGE,Manpura,Rural,344,223,121,223,67,156
8,110,90,81065,0,0,RAJASTHAN,Jaipur,VILLAGE,Hingoniya,Rural,237,157,80,179,66,113
8,110,90,81066,0,0,RAJASTHAN,Jaipur,VILLAGE,Shri Sahaipura,Rural,0,0,0,0,0,0
8,110,90,81067,0,0,RAJASTHAN,Jaipur,VILLAGE,Jagat Shiromanipura @ Toomli Ka Bas,Rural,594,392,202,590,226,364
8,110,90,81068,0,0,RAJASTHAN,Jaipur,VILLAGE,Khera Mukundpura,Rural,220,132,88,111,39,72
8,110,90,81069,0,0,RAJASTHAN,Jaipur,VILLAGE,Ladana Khurd,Rural,381,250,131,264,75,189
8,110,90,81070,0,0,RAJASTHAN,Jaipur,VILLAGE,Chaunp (Choonp),Rural,0,0,0,0,0,0
8,110,90,81071,0,0,RAJASTHAN,Jaipur,VILLAGE,Shri Niwaspura @ Ahiran Thooni,Rural,493,335,158,349,110,239
8,110,90,81072,0,0,RAJASTHAN,Jaipur,VILLAGE,Shri Nagar,Rural,0,0,0,0,0,0
8,110,90,81073,0,0,RAJASTHAN,Jaipur,VILLAGE,Moondiya Khurd,Rural,533,336,197,328,104,224
8,110,90,81074,0,0,RAJASTHAN,Jaipur,VILLAGE,Garhi Ramnagar,Rural,0,0,0,0,0,0
8,110,90,81075,0,0,RAJASTHAN,Jaipur,VILLAGE,Birdhpura @ Swami Ka Bas,Rural,355,243,112,314,112,202
8,110,90,81076,0,0,RAJASTHAN,Jaipur,VILLAGE,Barli,Rural,640,441,199,766,275,491
8,110,90,81077,0,0,RAJASTHAN,Jaipur,VILLAGE,Nainwa,Rural,107,68,39,84,27,57
8,110,90,81078,0,0,RAJASTHAN,Jaipur,VILLAGE,Kothoon,Rural,1503,986,517,1103,344,759
8,110,90,81079,0,0,RAJASTHAN,Jaipur,VILLAGE,Shri Brijpura,Rural,264,189,75,210,69,141
8,110,90,81080,0,0,RAJASTHAN,Jaipur,VILLAGE,Mahachandpura,Rural,240,160,80,181,52,129
8,110,90,81081,0,0,RAJASTHAN,Jaipur,VILLAGE,Rampura Bujurg,Rural,226,144,82,325,141,184
8,110,90,81082,0,0,RAJASTHAN,Jaipur,VILLAGE,Jaisinghpura,Rural,780,549,231,888,308,580
8,110,90,81083,0,0,RAJASTHAN,Jaipur,VILLAGE,Tigariya,Rural,276,202,74,230,75,155
8,110,90,81084,0,0,RAJASTHAN,Jaipur,VILLAGE,Girdharilalpura,Rural,587,384,203,574,225,349
8,110,90,81085,0,0,RAJASTHAN,Jaipur,VILLAGE,Bhoortiya Kalan,Rural,166,104,62,229,96,133
8,110,90,81086,0,0,RAJASTHAN,Jaipur,VILLAGE,Kishanpura,Rural,202,133,69,309,127,182
8,110,90,81087,0,0,RAJASTHAN,Jaipur,VILLAGE,Deeppura,Rural,0,0,0,0,0,0
8,110,90,81088,0,0,RAJASTHAN,Jaipur,VILLAGE,Sanwaliya,Rural,901,584,317,929,330,599
8,110,90,81089,0,0,RAJASTHAN,Jaipur,VILLAGE,Mahadeopura,Rural,370,229,141,273,102,171
8,110,90,81090,0,0,RAJASTHAN,Jaipur,VILLAGE,Deokinandanpura,Rural,181,111,70,177,64,113
8,110,90,81091,0,0,RAJASTHAN,Jaipur,VILLAGE,Raghunandanpura @ Kankata,Rural,476,323,153,573,231,342
8,110,90,81092,0,0,RAJASTHAN,Jaipur,VILLAGE,Shri Chandpura,Rural,35,23,12,32,14,18
8,110,90,81093,0,0,RAJASTHAN,Jaipur,VILLAGE,Malpuriya,Rural,327,209,118,310,113,197
8,110,90,81094,0,0,RAJASTHAN,Jaipur,VILLAGE,Ajmeripura,Rural,290,212,78,437,152,285
8,110,90,81095,0,0,RAJASTHAN,Jaipur,VILLAGE,Govindpura,Rural,244,158,86,330,125,205
8,110,90,81096,0,0,RAJASTHAN,Jaipur,VILLAGE,Anandpura,Rural,365,251,114,379,137,242
8,110,90,81097,0,0,RAJASTHAN,Jaipur,VILLAGE,Jahripura @ Basra,Rural,107,70,37,133,56,77
8,110,90,81098,0,0,RAJASTHAN,Jaipur,VILLAGE,Bheekarwar,Rural,89,56,33,117,49,68
8,110,90,81099,0,0,RAJASTHAN,Jaipur,VILLAGE,Badrinathpura,Rural,156,93,63,168,74,94
8,110,90,81100,0,0,RAJASTHAN,Jaipur,VILLAGE,Mandaliyan Meda,Rural,428,304,124,424,144,280
8,110,90,81101,0,0,RAJASTHAN,Jaipur,VILLAGE,Sanpla,Rural,247,154,93,253,98,155
8,110,90,81102,0,0,RAJASTHAN,Jaipur,VILLAGE,Tajpura,Rural,110,56,54,73,28,45
8,110,90,81103,0,0,RAJASTHAN,Jaipur,VILLAGE,Shakkar Khawada,Rural,637,442,195,705,270,435
8,110,90,81104,0,0,RAJASTHAN,Jaipur,VILLAGE,Jaiprakashpura,Rural,86,57,29,63,20,43
8,110,90,81105,0,0,RAJASTHAN,Jaipur,VILLAGE,Ashikpura @ Chaunrya,Rural,244,156,88,278,116,162
8,110,90,81106,0,0,RAJASTHAN,Jaipur,VILLAGE,Mohammadpura,Rural,126,85,41,165,64,101
8,110,90,81107,0,0,RAJASTHAN,Jaipur,VILLAGE,Nainwa Ki Dhani,Rural,122,78,44,92,40,52
8,110,90,81108,0,0,RAJASTHAN,Jaipur,VILLAGE,Nandgaon Basri,Rural,7,7,0,35,17,18
8,110,90,81109,0,0,RAJASTHAN,Jaipur,VILLAGE,Raghopura,Rural,139,98,41,156,53,103
8,110,90,81110,0,0,RAJASTHAN,Jaipur,VILLAGE,Ramniwas,Rural,824,561,263,804,306,498
8,110,90,81111,0,0,RAJASTHAN,Jaipur,VILLAGE,Vrindawanpura @ Roopwas,Rural,409,260,149,320,115,205
8,110,90,81112,0,0,RAJASTHAN,Jaipur,VILLAGE,Barodiya,Rural,611,416,195,635,225,410
8,110,90,81113,0,0,RAJASTHAN,Jaipur,VILLAGE,Nandlalpura,Rural,254,167,87,246,94,152
8,110,90,81114,0,0,RAJASTHAN,Jaipur,VILLAGE,Kohlya,Rural,567,389,178,580,187,393
8,110,90,81115,0,0,RAJASTHAN,Jaipur,VILLAGE,Maheshpura,Rural,326,225,101,377,149,228
8,110,90,81116,0,0,RAJASTHAN,Jaipur,VILLAGE,Laxmipura,Rural,257,171,86,232,86,146
8,110,90,81117,0,0,RAJASTHAN,Jaipur,VILLAGE,Khera Jagannathpura,Rural,299,203,96,338,139,199
8,110,90,81118,0,0,RAJASTHAN,Jaipur,VILLAGE,Barh Murlipura,Rural,690,470,220,997,397,600
8,110,90,81119,0,0,RAJASTHAN,Jaipur,VILLAGE,Barh Rajpura,Rural,235,141,94,219,89,130
8,110,90,81120,0,0,RAJASTHAN,Jaipur,VILLAGE,Garoodwasi,Rural,858,538,320,739,287,452
8,110,90,81121,0,0,RAJASTHAN,Jaipur,VILLAGE,Yadgarpura,Rural,157,96,61,137,52,85
8,110,90,81122,0,0,RAJASTHAN,Jaipur,VILLAGE,Barh Yadgarpura,Rural,64,42,22,100,48,52
8,110,90,81123,0,0,RAJASTHAN,Jaipur,VILLAGE,Ralawata,Rural,342,221,121,322,126,196
8,110,90,81124,0,0,RAJASTHAN,Jaipur,VILLAGE,Nangal Lar,Rural,152,98,54,146,56,90
8,110,90,81125,0,0,RAJASTHAN,Jaipur,VILLAGE,Prithvi Pura,Rural,0,0,0,0,0,0
8,110,90,81126,0,0,RAJASTHAN,Jaipur,VILLAGE,Kushalpura,Rural,116,82,34,101,34,67
8,110,90,81127,0,0,RAJASTHAN,Jaipur,VILLAGE,Maharajpura,Rural,197,129,68,182,76,106
8,110,90,81128,0,0,RAJASTHAN,Jaipur,VILLAGE,Jaitpura,Rural,47,27,20,59,28,31
8,110,90,81129,0,0,RAJASTHAN,Jaipur,VILLAGE,Narsinghpura,Rural,236,158,78,197,61,136
8,110,90,81130,0,0,RAJASTHAN,Jaipur,VILLAGE,Barh Shyampura,Rural,0,0,0,0,0,0
8,110,90,81131,0,0,RAJASTHAN,Jaipur,VILLAGE,Shyampura,Rural,382,230,152,288,117,171
8,110,90,81132,0,0,RAJASTHAN,Jaipur,VILLAGE,Garhi Lashkari,Rural,261,158,103,182,76,106
8,110,90,81133,0,0,RAJASTHAN,Jaipur,VILLAGE,Kanwarpura,Rural,589,383,206,492,194,298
8,110,90,81134,0,0,RAJASTHAN,Jaipur,VILLAGE,Nenoopura,Rural,338,210,128,323,118,205
8,110,90,81135,0,0,RAJASTHAN,Jaipur,VILLAGE,Narottampura,Rural,644,429,215,561,205,356
8,110,90,81136,0,0,RAJASTHAN,Jaipur,VILLAGE,Chak Cheemapura,Rural,0,0,0,0,0,0
8,110,90,81137,0,0,RAJASTHAN,Jaipur,VILLAGE,Cheemapura,Rural,383,263,120,337,124,213
8,110,90,81138,0,0,RAJASTHAN,Jaipur,VILLAGE,Kushalpura,Rural,232,153,79,227,97,130
8,110,90,81139,0,0,RAJASTHAN,Jaipur,VILLAGE,Kheraraniwas,Rural,402,257,145,350,139,211
8,110,90,81140,0,0,RAJASTHAN,Jaipur,VILLAGE,Chak Chaurasi,Rural,0,0,0,0,0,0
8,110,90,81141,0,0,RAJASTHAN,Jaipur,VILLAGE,Ramchandrapura,Rural,395,267,128,440,175,265
8,110,90,81142,0,0,RAJASTHAN,Jaipur,VILLAGE,Jagdishpura,Rural,337,210,127,429,183,246
8,110,90,81143,0,0,RAJASTHAN,Jaipur,VILLAGE,Barh Maharajpura,Rural,201,126,75,166,67,99
8,110,90,81144,0,0,RAJASTHAN,Jaipur,VILLAGE,Chak Maharajpura,Rural,21,14,7,28,9,19
8,110,90,81145,0,0,RAJASTHAN,Jaipur,VILLAGE,Chak Vinodilalpura No.2,Rural,16,12,4,33,17,16
8,110,90,81146,0,0,RAJASTHAN,Jaipur,VILLAGE,Chak Vinodilalpura No.1,Rural,81,54,27,69,25,44
8,110,90,81147,0,0,RAJASTHAN,Jaipur,VILLAGE,Orangpura,Rural,75,47,28,29,9,20
8,110,90,81148,0,0,RAJASTHAN,Jaipur,VILLAGE,Rughanathpura @God Ka Bas,Rural,264,176,88,248,90,158
8,110,90,81149,0,0,RAJASTHAN,Jaipur,VILLAGE,Maharajpura,Rural,157,100,57,98,37,61
8,110,90,81150,0,0,RAJASTHAN,Jaipur,VILLAGE,Dobla Kalan,Rural,426,309,117,682,267,415
8,110,90,81151,0,0,RAJASTHAN,Jaipur,VILLAGE,Vinodilalpura,Rural,128,96,32,127,34,93
8,110,90,81152,0,0,RAJASTHAN,Jaipur,VILLAGE,Ramnagar,Rural,556,362,194,611,255,356
8,110,90,81153,0,0,RAJASTHAN,Jaipur,VILLAGE,Roopnagar,Rural,32,21,11,24,10,14
8,110,90,81154,0,0,RAJASTHAN,Jaipur,VILLAGE,Tallukpur Doongri,Rural,83,59,24,47,18,29
8,110,90,81155,0,0,RAJASTHAN,Jaipur,VILLAGE,Hirapura,Rural,460,307,153,399,158,241
8,110,90,81156,0,0,RAJASTHAN,Jaipur,VILLAGE,Madan Mohanpura @ Thooni,Rural,192,127,65,242,114,128
8,110,90,81157,0,0,RAJASTHAN,Jaipur,VILLAGE,Vimalpura,Rural,346,236,110,394,162,232
8,110,90,81158,0,0,RAJASTHAN,Jaipur,VILLAGE,Garh Ka Para,Rural,254,180,74,419,162,257
8,110,90,81159,0,0,RAJASTHAN,Jaipur,VILLAGE,Jhapda Kalan,Rural,1179,761,418,851,335,516
8,110,90,81160,0,0,RAJASTHAN,Jaipur,VILLAGE,Barh Babanpura,Rural,156,90,66,82,21,61
8,110,90,81161,0,0,RAJASTHAN,Jaipur,VILLAGE,Barh Fatehpura,Rural,0,0,0,0,0,0
8,110,90,81162,0,0,RAJASTHAN,Jaipur,VILLAGE,Keshopura,Rural,229,147,82,232,77,155
8,110,90,81163,0,0,RAJASTHAN,Jaipur,VILLAGE,Barh Keshopura,Rural,0,0,0,0,0,0
8,110,90,81164,0,0,RAJASTHAN,Jaipur,VILLAGE,Ajairajpura @ Dehlala,Rural,602,401,201,812,357,455
8,110,90,81165,0,0,RAJASTHAN,Jaipur,VILLAGE,Chak Bawanpura,Rural,0,0,0,0,0,0
8,110,90,81166,0,0,RAJASTHAN,Jaipur,VILLAGE,Balmukundpura @ Basra,Rural,605,381,224,655,268,387
8,110,90,81167,0,0,RAJASTHAN,Jaipur,VILLAGE,Theekariya Goojran,Rural,741,491,250,761,293,468
8,110,90,81168,0,0,RAJASTHAN,Jaipur,VILLAGE,Bawanpura,Rural,142,83,59,174,69,105
8,110,90,81169,0,0,RAJASTHAN,Jaipur,VILLAGE,Vishanpura,Rural,198,118,80,190,79,111
8,110,90,81170,0,0,RAJASTHAN,Jaipur,VILLAGE,Kankariya,Rural,194,142,52,194,63,131
8,110,90,81171,0,0,RAJASTHAN,Jaipur,VILLAGE,Bhidkyawas,Rural,114,77,37,111,45,66
8,110,90,81172,0,0,RAJASTHAN,Jaipur,VILLAGE,Nandkishorpura,Rural,138,97,41,174,64,110
8,110,90,81173,0,0,RAJASTHAN,Jaipur,VILLAGE,Dharampuri,Rural,127,84,43,171,66,105
8,110,90,81174,0,0,RAJASTHAN,Jaipur,VILLAGE,Khejri Khurd,Rural,218,144,74,325,129,196
8,110,90,81175,0,0,RAJASTHAN,Jaipur,VILLAGE,Barh Chauhan,Rural,53,35,18,86,37,49
8,110,90,81176,0,0,RAJASTHAN,Jaipur,VILLAGE,Chak Sampatpura,Rural,28,21,7,26,12,14
8,110,90,81177,0,0,RAJASTHAN,Jaipur,VILLAGE,Shri Sampatpura,Rural,133,84,49,121,47,74
8,110,90,81178,0,0,RAJASTHAN,Jaipur,VILLAGE,Theekariya Meenan,Rural,697,476,221,866,346,520
8,110,90,81179,0,0,RAJASTHAN,Jaipur,VILLAGE,Chak Barh Babanpura,Rural,0,0,0,0,0,0
8,110,90,81180,0,0,RAJASTHAN,Jaipur,VILLAGE,Trilokinathpura,Rural,314,211,103,327,132,195
8,110,90,81181,0,0,RAJASTHAN,Jaipur,VILLAGE,Barh Parmanandpura,Rural,48,32,16,81,37,44
8,110,90,81182,0,0,RAJASTHAN,Jaipur,VILLAGE,Shri Raghunathpura,Rural,98,58,40,145,54,91
8,110,90,81183,0,0,RAJASTHAN,Jaipur,VILLAGE,Dwarkpura,Rural,158,112,46,258,107,151
8,110,90,81184,0,0,RAJASTHAN,Jaipur,VILLAGE,Parmanandpura,Rural,22,16,6,36,18,18
8,110,90,81185,0,0,RAJASTHAN,Jaipur,VILLAGE,Shripura,Rural,70,53,17,129,49,80
8,110,90,81186,0,0,RAJASTHAN,Jaipur,VILLAGE,Goojar Hera,Rural,43,31,12,79,33,46
8,110,90,81187,0,0,RAJASTHAN,Jaipur,VILLAGE,Parmanandpura @ Mandaliya,Rural,123,99,24,346,140,206
